我=們 國 軍 方 黨 自 鎮 行 得 日 倒 吐 暈 的 要 想 是 所 也 會 就 很 說 看 真 不 又 一 好 亦 來 愛 去 心 從 曾 才 到 將 把 家 見 問 能 呢 先 愿 校 等 倆 得 行 開 讓 猜 媽 部 爸 處 靠 操 輩 廠 局 院 省 市 縣 欲 
一=個 點 切 定 樣 些 面 下 般 邊 直 陣 塊 起 時 同 半 番 對 齊 月 道 來 路 手 向 生 二 身 帶 致 代 動 頭 旦 共 刻 角 旁 行 氣 等 律 早 派 線 味 端 度 心 連 流 世 概 再 貫 舉 經 體 級 無 并 發 斑 瞬 總 準 霎 覽 力 愣 眨 院 搖 維 潭 甩 畝 江 拜 帖 坨 搜 輝 扔 年 頁 次 種 張 九 項 位 日 天 名 百 份 段 套 條 件 間 兩 千 只 場 句 部 人 家 大 篇 本 片 號 群 所 分 期 步 萬 班 層 是 事 宗 看 周 支 幅 樓 座 顆 首 聲 批 組 詞 方 站 如 類 封 八 股 把 屆 筆 中 夜 輛 杯 書 晚 處 章 成 會 臺 五 輪 節 倍 口 職 族 歲 雙 三 笑 款 國 票 提 副 十 門 六 眼 遍 幕 隊 根 頓 回 見 文 則 字 到 秒 招 枝 科 堆 粒 問 有 聽 季 棵 零 課 按 絲 臉 出 艘 幢 熱 跳 想 開 說 趟 毛 語 員 堂 元 碗 地 枚 不 擊 驚 審 查 團 腳 上 卷 排 仗 女 新 言 睹 式 去 轉 圈 曲 餐 朵 格 串 物 記 學 談 盒 包 戰 具 滴 己 列 例 多 輩 米 死 關 展 瓶 案 閃 響 刀 改 躍 聞 冊 數 版 掌 揮 株 講 束 盤 變 從 拳 進 匹 推 通 讀 走 盞 統 者 沉 紙 朝 命 斤 空 用 民 寸 扇 疊 子 汽 任 毫 頂 足 夕 幀 瞥 籌 現 品 局 側 碟 樁 要 掃 袋 伙 幫 長 拉 截 青 息 絕 打 棟 罐 船 劑 折 摸 村 尺 做 坐 戶 怒 槍 收 合 遇 軍 義 水 色 隅 聚 丁 針 樂 吹 馬 介 睡 縷 車 碰 桌 街 橫 彈 干 服 清 窩 廳 桶 丈 破 畫 葉 應 擺 哭 市 壺 磅 對 明 撮 扭 遭 跤 鍋 管 吸 晃 夢 籃 脈 灘 錯 瓣 炮 鍵 景 等 行 忙 偏 腔 是 剎 辦 抱 插 鏟 產 匙 簇 檔 店 噸 桿 搞 喊 滑 徑 覺 捆 壘 里 溜 賣 屏 鍬 敲 豎 順 似 鎖 丸 寫 咬 緣 扎 兆 泓 綹 
沒=有 落 收 臉 趣 命 羞 準 影 要 心 回 敢 干 底 啦 話 病 進 貨 滿 換 份 治 人 法 想 事 錯 見 說 用 能 錢 了 聽 被 做 空 啥 得 去 來 到 變 問 完 吃 譜 理 給 味 過 睡 死 大 戲 入 詞 頂 勁 救 門 他 緣 轍 齒 爹 路 提 頭 小 效 種 
他=們 用 人 爸 行 的 說 是 對 有 也 所 會 就 不 將 從 能 來 這 想 國 日 家 問 方 行 年 鄉 處 個 物 殺 媽 傷 倆 律 因 
什=么 物 錦 
自=己 然 由 從 殺 信 覺 家 我 在 動 身 稱 私 居 傳 語 治 豪 傲 序 主 慰 立 幼 古 行 負 衛 尊 愿 制 命 述 問 大 白 滿 修 愛 盡 夸 強 如 卑 發 足 救 重 持 備 娛 找 首 拔 用 便 餒 理 勉 選 個 絕 恃 學 決 薦 律 抑 展 珍 因 謂 省 曝 愧 糾 好 管 宮 斃 摸 造 轉 封 貢 習 養 籌 忖 咎 訴 肥 供 控 助 此 小 有 成 認 設 創 知 費 爆 編 保 閉 是 新 責 定 體 焚 明 營 為 嘲 相 取 利 毀 詡 評 建 生 拍 得 來 力 欺 外 辦 殘 戀 導 憐 愈 給 演 視 帶 守 暴 食 應 經 刎 甘 各 若 顧 感 虐 分 傷 謙 燃 流 量 勵 留 辨 查 測 裁 沉 乘 吹 慚 打 瀆 奉 反 管 顧 疚 剄 矜 戕 棄 遣 贖 銷 縊 矮 報 貶 產 檢 解 警 凈 考 料 通 許 旋 
知=道 識 縣 己 名 覺 心 了 事 音 情 青 曉 悉 底 交 法 母 會 之 性 足 無 客 州 賓 恥 單 府 命 趣 遇 照 罪 
可=是 以 能 憐 愛 惜 怕 笑 見 知 靠 惡 喜 謂 恨 望 貴 觀 恥 好 敬 疑 取 悲 信 否 口 行 憎 氣 巧 鄙 嘉 變 汗 鉆 餐 體 逆 在 于 獲 供 用 向 為 將 作 分 與 達 按 說 由 有 被 選 得 不 成 自 再 就 算 對 隨 樂 先 看 言 做 視 循 親 要 真 憑 因 比 給 轉 放 及 當 去 人 尋 曾 防 也 風 圖 寫 想 讀 聽 別 出 數 我 卑 怖 求 辨 他 拉 聞 心 惱 怪 驚 名 欺 身 嘆 調 意 止 著 ? 拔 賀 豆 粉 樹 佩 騎 染 溶 塑 掬 
時=候 間 代 期 節 常 髦 光 刻 而 事 機 局 裝 勢 人 辰 日 分 務 興 鐘 尚 下 運 不 令 值 宜 價 文 政 氣 樣 針 薪 經 近 稱 長 序 差 評 鮮 疫 段 限 效 調 速 至 有 說 會 報 空 許 需 艱 逢 計 見 區 點 弊 態 隔 新 論 變 病 或 世 輪 年 取 任 
因=為 此 而 緣 素 果 襲 明 子 由 故 應 其 著 我 病 之 傷 公 數 循 私 式 患 
這=樣 個 些 里 么 時 兒 點 邊 尊 廂 扇 匹 輪 圖 帖 是 種 項 一 次 類 位 就 段 份 件 也 套 條 句 部 方 場 批 才 間 將 篇 本 可 筆 會 不 群 只 話 款 人 張 家 使 天 宗 塊 番 股 又 片 等 般 幅 要 道 還 年 顆 回 叫 輛 下 則 臺 面 層 卻 副 陣 頭 枚 樁 歌 雙 招 倒 根 山 身 代 幫 水 得 口 車 廝 伙 屆 桶 碗 
起=來 頭 身 初 見 床 碼 筆 伏 源 點 義 先 立 哄 事 火 居 落 草 兵 飛 家 因 色 訴 名 用 跳 運 子 釘 繭 步 錨 動 毛 了 一 到 著 開 舞 始 手 行 誓 首 勁 眼 跑 電 更 風 降 疑 腳 獲 泡 價 岸 浪 膩 爆 霸 碇 吊 航 復 旱 貨 稿 根 卦 敬 解 駕 課 拍 訖 算 臥 興 夜 意 由 重 贓 止 早 租 喘 急 雷 音 皺 
就=是 要 算 此 手 近 地 職 寢 讀 任 業 緒 范 座 勢 醫 便 里 位 遠 數 素 診 餐 會 有 像 在 可 能 不 如 其 更 連 好 以 得 說 很 讓 中 已 去 成 將 與 學 應 沒 叫 越 到 向 來 行 教 正 想 因 問 曾 夠 使 看 都 著 跑 講 憑 差 愛 食 怕 合 睡 伴 捕 道 殲 聘 擒 席 義 簡 
現=在 代 實 象 出 成 狀 今 錢 款 時 存 洋 有 世 行 任 場 金 眼 貨 勢 役 年 樓 地 鈔 況 已 身 為 價 職 將 是 形 予 下 值 丑 漢 匯 房 話 局 期 賣 
覺=得 著 悟 醒 察 出 民 
已=經 閱 離 發 有 在 被 是 獲 成 為 由 將 就 達 久 到 不 知 婚 可 很 定 能 對 過 故 死 近 用 盡 滿 出 去 然 給 非 付 晚 失 退 往 極 遠 而 待 
但=是 書 在 我 他 這 卻 有 也 仍 不 要 對 她 因 又 其 若 它 從 如 你 很 最 都 可 愿 該 就 到 會 與 總 那 須 沒 更 見 能 被 求 應 還 需 隨 看 比 凡 受 均 聽 把 丁 虧 所 子 
所=以 謂 有 在 得 屬 部 造 引 系 迷 需 作 說 提 載 述 用 能 指 列 持 致 見 知 做 要 受 學 占 言 示 講 生 限 發 賜 及 寫 獲 為 帶 選 犯 處 愛 收 設 想 傳 求 成 舉 創 聞 愿 稱 出 料 教 立 是 欠 辦 至 花 幸 缺 好 剩 傷 困 累 向 畫 歸 迫 轄 輸 長 藏 唱 干 建 經 居 取 殺 譯 遇 撰 
出=來 去 版 現 門 于 身 發 息 口 路 神 賣 色 國 嫁 乎 奇 入 名 自 世 事 頭 家 生 力 氣 手 面 席 走 產 外 院 場 品 土 租 沒 馬 血 售 獄 眾 丑 車 動 游 征 處 師 兵 差 臺 錯 使 行 海 境 診 軌 擊 任 籠 落 巡 廠 氣 典 活 納 題 奔 格 庭 示 陣 操 團 齊 刊 腳 讓 超 工 獵 訪 航 借 逃 勤 項 了 時 更 新 在 道 位 局 資 爐 貨 線 價 戰 對 賽 書 過 具 聲 招 錢 到 水 言 戲 警 盡 山 汗 報 關 城 港 鏡 界 浴 清 欄 膿 殯 缺 完 苗 票 量 科 迎 飯 列 溜 不 榜 彩 槽 乘 倒 頂 伏 號 禍 閣 恭 鍋 繼 九 圈 庫 梅 煤 偏 盤 聘 圃 喪 仕 首 數 塞 攤 挑 糶 徒 脫 亡 險 演 洋 語 月 展 賬 蟄 洞 離 鞘 球 鐵 站 
中=國 間 心 央 學 年 人 華 文 用 秋 外 午 等 途 原 看 庸 西 流 和 聽 旬 斷 飯 醫 止 立 山 部 葉 指 小 轉 風 毒 農 道 堂 肯 期 裝 將 傷 共 游 篇 下 東 級 堅 選 隊 空 樞 表 藥 層 式 路 暑 尉 專 方 服 餐 耳 性 保 線 型 焦 職 報 搜 士 統 點 縫 號 獎 介 伏 鋪 衛 校 策 雨 子 詞 鋒 耕 腦 師 音 環 有 英 大 港 美 資 區 信 銀 日 去 段 使 南 場 了 上 加 分 度 俄 招 正 興 長 常 來 標 古 巴 天 考 意 繼 亞 油 航 新 法 歐 非 班 火 彈 廣 計 簽 直 土 槍 軸 邪 州 水 稻 越 欄 氣 泰 檔 控 柱 庭 夜 朝 休 蘇 程 影 行 營 的 波 飽 彩 超 輟 ? 浣 幡 鵠 甲 局 技 軍 舉 楷 饋 魔 盤 頻 廳 雪 夏 允 灶 板 寶 村 都 短 觀 江 景 寧 橋 圈 省 說 速 桅 緯 陽 院 岳 值 
還=是 有 要 給 債 愿 手 禮 價 擊 原 嘴 給 本 會 未 在 可 沒 能 說 將 不 須 需 得 很 好 應 想 算 多 對 用 看 真 請 來 差 俗 只 小 叫 望 怕 問 剩 敢 去 不 魂 撞 我 報 抱 家 款 口 清 情 書 行 鄉 席 陽 賬 缺 似 大 高 過 快 錢 痛 
看=見 到 來 出 護 法 成 上 待 守 報 作 中 望 透 重 好 病 門 家 輕 破 管 穿 似 頭 臺 齊 青 住 些 慣 碟 熟 不 全 去 你 押 過 得 著 了 的 這 我 完 他 書 你 清 是 顧 那 淡 人 板 圖 吧 下 準 戲 漲 對 去 官 相 花 跌 錯 海 俏 一 懂 點 開 老 了 茶 承 車 低 吧 客 是 死 攤 秀 走 座 扁 打 燈 稿 漏 球 誰 呀 樣 
你=們 好 還 丫 爸 請 牛 行 強 的 是 有 要 可 想 對 說 也 就 所 看 都 一 能 我 去 將 把 來 呢 從 個 呀 先 家 等 老 被 猜 行 早 處 瞧 倆 呢 吶 方 
不=過 要 可 住 同 大 肯 必 好 見 得 但 再 少 管 用 行 錯 如 久 曾 能 想 怕 成 夠 免 然 對 許 斷 便 幸 得 足 準 安 易 料 論 覺 僅 及 止 妨 通 忍 平 理 禁 定 比 等 問 顧 滿 和 合 堪 時 快 只 一 單 配 容 勝 解 拘 可 當 宜 變 明 惜 已 服 良 妥 致 利 外 甘 光 妙 善 依 息 周 獨 巧 靈 愧 適 休 圖 惟 符 乏 齒 畏 慎 端 公 賴 法 力 諱 拒 恥 疼 碰 攔 沉 軌 能 會 是 負 到 知 應 多 敢 太 懂 停 受 了 在 出 愿 需 清 正 連 算 認 信 去 起 分 像 完 開 說 為 作 動 被 愛 接 高 盡 上 讓 屬 難 須 俗 支 限 來 下 就 忘 做 遠 該 佳 以 發 念 懈 聽 失 死 經 放 打 把 至 含 予 給 計 絕 詳 散 雅 看 吃 加 順 輕 與 改 具 實 穩 回 保 甚 求 復 敵 小 振 識 熟 舍 減 言 留 治 思 義 二 生 收 無 允 全 干 關 語 從 使 屑 滅 走 常 帶 答 講 很 深 凡 透 入 朽 掉 爭 長 均 遇 強 樂 叫 備 消 遂 潔 近 低 敗 前 倒 值 枉 菲 棄 惑 壞 屈 興 按 由 進 悅 降 中 偏 濟 傷 敬 亂 假 差 孕 占 聞 落 殺 露 早 厭 脫 愁 待 忠 育 眠 白 買 誤 教 遲 歸 學 智 痛 美 移 急 懼 達 檢 貴 弱 測 齊 純 都 渝 抱 羈 驚 防 吝 果 避 嚴 怪 孝 穿 喝 啻 暢 仁 賣 擅 衰 寧 慢 讀 虛 靠 交 嫌 老 忿 活 吉 祥 遜 輸 特 遑 隙 淺 日 爽 漏 睡 耐 哭 短 肖 笑 疑 專 克 置 嫁 累 費 倦 搞 慣 戰 丹 辭 才 拿 醒 請 諳 苦 忙 醉 饒 花 換 送 輟 慌 怨 懇 象 佞 逞 揣 憚 迭 但 茍 敏 睦 毛 么 跑 偷 韙 謂 暇 恤 謝 揚 虞 貲 子 拔 擺 薄 查 抽 第 調 恭 恨 還 竭 借 靜 咎 亮 領 瞞 冒 謀 憑 迫 辱 曬 刪 剩 縮 甜 晚  展 貞 著 悖 
東=西 方 京 北 洋 南 邊 風 家 海 面 道 頭 歐 臨 瀛 經 宮 區 亞 華 部 周 芝 至 岸 盟 路 山 江 街 漢 尼 寧 門 湖 平 晉 非 吳 角 坡 征 流 去 側 升 向 城 線 站 渡 陵 川 床 單 胡 氿 莞 虢 郭 郊 ? ? 土 魏 野 岳 君 園 阿 安 廠 村 德 都 端 段 豐 溝 光 航 加 進 蘭 遼 明 勝 四 臺 廂 鄉 興 陽 營 
先=生 前 是 后 進 知 行 鋒 天 驅 人 輩 哲 賢 烈 例 聲 頭 兆 決 期 導 世 端 河 遣 到 得 要 在 把 從 說 秦 來 機 看 于 取 考 出 見 達 寫 祖 付 驗 民 師 覺 王 令 容 不 妣 帝 父 手 主 嘗 夫 公 過 母 占 
那=么 個 些 里 樣 時 邊 兒 株 匹 回 層 幫 廝 跟 一 是 就 種 天 位 份 年 次 人 你 段 有 條 只 般 又 日 間 也 英 不 場 句 件 夜 在 張 對 會 可 顆 晚 塊 股 本 將 套 還 雙 所 要 班 家 座 群 篇 頭 類 女 才 副 片 封 幅 支 道 叫 批 口 山 點 項 根 面 番 臺 用 車 倒 曲 水 
大=家 概 學 哥 約 門 人 小 半 眾 嫂 爺 會 事 姐 抵 地 衣 海 街 膽 都 好 媽 方 量 致 鼓 紅 雨 臣 道 路 意 樹 多 字 師 腿 陸 炮 步 隊 批 洋 王 風 褂 地 叔 作 娘 氣 體 雪 戰 同 煙 兵 漢 為 名 腳 樓 年 略 刀 伙 車 廈 喜 餅 軍 水 局 義 將 魚 部 殿 火 伯 勢 氅 力 菜 戶 權 戲 雅 頭 連 錢 典 綱 于 襟 型 業 副 國 號 禍 壩 嬸 班 蔥 考 志 節 全 敵 過 肆 帝 漠 寫 度 話 宗 便 米 我 象 阪 舉 旱 蒜 佛 霧 潮 慶 赦 法 干 麥 使 雁 蟲 端 曲 寨 辦 姑 腦 任 旨 敗 油 豆 亨 捷 吏 糞 梁 族 寒 獎 課 縣 化 吹 羅 器 蝦 姓 姨 腸 麻 校 牙 政 槍 田 專 篆 棒 暑 數 選 灶 關 料 溜 刑 要 的 城 浪 幅 角 坑 賽 公 堂 中 有 聲 澳 了 利 叫 增 行 橋 衛 圍 堆 而 開 發 市 但 受 類 成 口 碟 石 跌 計 新 笑 能 一 片 球 興 變 不 佬 馬 廳 手 熱 展 分 個 河 怒 明 把 派 眼 件 案 和 網 驚 群 甲 德 唐 林 功 贊 筆 俠 漲 額 屋 喊 哭 元 通 打 勝 礙 食 塊 鵬 談 難 白 山 千 講 東 賞 華 跳 項 亂 加 罵 悲 包 書 很 出 理 段 解 觀 智 面 吃 江 調 碗 吉 匙 呼 報 餐 鬧 指 洞 三 獲 女 所 病 罪 肚 忌 禮 汗 則 呢 圣 修 旗 盛 神 錯 破 經 詞 系 放 弟 平 搞 二 動 用 廠 做 本 勇 宅 蛇 牌 院 壺 尉 些 嚷 船 袋 盤 豐 限 盜 降 龍 官 宇 唱 內 熊 建 廚 吵 壽 黑 喝 覺 房 張 且 鐘 巴 恩 藍 震 的 安 顯 災 鳥 黃 吼 楷 野 粒 團 四 假 毛 板 凡 肉 哥 姐 洲 燈 黨 兇 杯 區 嚼 北 戒 青 藏 幸 駕 虧 宴 湖 儒 腕 忙 不 齡 拿 鱷 牢 殮 鯢 寧 逆 綠 阮 顎 伯 補 鴇 別 處 鈔 沖 春 錘 村 椎 倉 憝 堤 夫 害 患 哈 故 管 蕉 盡 劫 舅 款 夼 夢 謬 辟 票 秦 帥 順 屯 土 悟 汛 月 愚 庸 鹽 樣 員 印 棗 抓 站 治 早 醉 著 媒 雕 癡 擺 川 點 釘 鼎 賭 鍛 封 港 鍋 幾 薊 季 間 君 纜 郎 里 良 牛 棚 鼠 桶 統 洼 巫 仙 姚 冶 邑 余 禹 澤 枝 足 
怎=么 樣 肯 敢 能 會 知 生 地 奈 的 
個=人 性 子 頭 兒 別 體 數 位 月 案 字 唱 股 中 例 夠 舊 把 
許=多 可 愿 諾 昌 是 下 久 婚 配 晴 仙 
也=是 許 好 罷 指 回 怪 敢 有 可 會 不 要 很 能 在 沒 就 將 曾 應 為 被 都 只 說 非 無 想 正 因 較 對 使 未 與 已 給 讓 令 同 比 難 看 受 從 以 需 來 作 和 像 還 算 更 成 用 常 由 須 該 向 稱 請 做 叫 搞 聽 去 談 太 別 門 怕 才 似 行 先 挺 夠 仍 
地=方 上 位 下 點 獄 道 步 面 球 主 板 圖 區 毯 理 址 堡 名 帶 震 勢 形 質 盤 皮 攤 價 段 壓 學 窖 鋪 層 心 痞 域 保 洞 產 處 雷 基 氣 租 極 界 契 利 空 殼 支 頭 積 鐵 瓜 牢 力 外 跨 滾 柜 熱 脈 溫 表 溝 角 志 衣 秤 磁 黃 塊 貌 勤 權 稅 委 物 線 穴 說 政 氈 庫 會 臺 底 里 市 電 對 蠟 平 標 槽 壇 峽 緣 磚 陷 漏 兒 栗 量 鄰 龍 裂 壘 纜 磅 鱉 波 燈 丁 膚 府 核 宮 埂 籍 腳 礦 膜 幔 畝 煞 刷 神 軸 富 滑 火 級 精 坑 坪 錢 鼠 轉 
而=且 是 已 后 言 外 今 況 望 落 當 在 設 不 非 成 定 有 我 又 作 來 無 他 要 去 出 行 生 使 與 死 發 下 起 未 能 過 你 更 論 立 至 把 知 入 歸 活 就 再 戰 終 逃 居 然 別 盡 談 散 哭 光 樂 臥 憂 
生=活 命 氣 意 產 長 存 動 日 病 物 死 于 平 人 涯 前 計 疏 理 育 怕 來 機 硬 成 根 態 就 路 客 趣 還 殖 地 息 字 性 財 澀  養 分 冷 菜 母 擒 肉 肖 效 靈 手 鐵 光 僻 水 疑 姜 絲 漆 員 豬 油 父 角 威 業 的 有 化 為 出 子 得 起 下 事 境 辰 仔 火 發 輝 身 猛 厭 離 變 吃 面 熱 相 料 奶 搬 詞 齒 湊 法 番 俘 風 膠 恐 壙 煤 脈 皮 色 土 疼 吞 消 源 藥 造 達 話 荒 霉 米 滅 民 膿 坯 時 勢 鮮 蹼 
孩=子 兒 童 提 
似=乎 的 火 是 有 地 水 能 的 鋼 錦 
雖=然 說 則 無 不 未 小 能 
今=天 日 年 后 兒 人 朝 晨 譯 文 次 晚 生 夏 夜 世 宵 起 昔 明 秋 番 是 夕 草 春 冬 歲 音 
對=于 面 付 方 象 話 聯 待 手 照 立 比 外 抗 準 白 峙 頭 子 勁 質 稱 答 證 內 襟 策 應 打 本 偶 唱 角 壘 等 光 口 路 之 贈 看 勾 調 流 弈 歌 開 蝦 號 局 數 此 我 他 其 的 人 上 你 她 著 一 臺 不 有 生 當 家 華 保 了 它 兒 消 事 沖 地 焦 誰 談 嗎 戰 過 岸 正 國 錯 您 天 決 接 換 陣 不 齊 門 分 呀 眼 空 案 敵 心 視 飲 轉 位 講 罵 半 攻 擂 臉 簿 詞 裁 工 獎 親 為 味 癥 折 仗 酌 邊 公 價 進 徑 句 賬 軸 
并=不 且 非 肩 排 列 立 進 舉 存 吞 發 重 受 起 就 集 罰 蒂 攏 力 無 在 于 以 將 會 未 為 可 由 向 已 有 與 沒 須 能 把 要 使 按 提 用 請 說 購 從 曾 出 被 附 行 同 入 派 稱 聯 和 網 置 茂 到 論 合 處 轉 生 報 先 案 骨 軌 線 蓄 口 
只=有 是 要 好 能 得 見 管 顧 用 怕 求 限 身 字 圖 配 過 夠 會 需 可 供 在 須 想 為 因 占 說 剩 看 聽 讀 對 準 把 應 收 道 售 給 眼 差 由 做 當 憑 講 愛 將 消 愿 怪 許 此 留 讓 等 問 記 賣 比 跟 和 像 算 替 認 
以=為 后 前 及 外 來 上 便 下 至 免 致 往 內 北 西 南 東 次 此 供 作 在 期 其 防 求 示 使 資 大 對 備 待 巴 之 近 太 降 道 遠 
朋=友 黨 克 
心=里 中 情 理 頭 靈 想 事 思 眼 跳 境 目 血 底 腸 疼 地 愛 意 緒 臟 愿 肝 胸 態 坎 力 酸 虛 腹 神 口 得 病 軟 機 路 懷 房 氣 聲 細 窩 弦 子 計 潮 曲 靜 碎 悸 術 性 切 田 跡 竅 尖 志 勁 火 扉 藥 肌 髓 音 膽 魄 室 的 生 有 如 智 急 痛 動 存 定 儀 肺 經 向 上 安 結 寒 煩 驚 魔 貼 電 間 學 慌 算 身 傷 服 律 連 系 醉 照 涼 領 率 包 材 傳 毒 海 狠 浮 黑 花 甘 高 焦 寬 盛 數 衰 土 秀 硬 重 窄 戰 兒 折 耳 亂 囊 香 軸 
女=人 兒 子 士 性 孩 生 婿 仆 郎 傭 工 友 神 權 王 家 方 流 巫 皇 排 真 裝 兵 式 色 史 表 將 貞 星 籃 的 仔 童 優 警 校 聲 單 服 嬰 鞋 伴 中 帽 鬼 俠 尸 用 侍 足 媧 隊 廁 壘 奴 伶 賓 紅 官 眷 角 客 氣  雙 團 娃 冠 監 杰 褲 妖 
事=情 實 業 兒 物 件 后 變 跡 務 先 前 故 理 例 由 項 宜 端 略 主 態 機 權 假 發 關 隔 典 體 畢 
母=親 女 子 雞 性 愛 校 盤 腹 乳 體 系 音 教 機 語 的 嬰 豹 株 后 艦 牛 本 畜 法 蜂 國 金 樹 線 液 羊 質 鐘 豬 鹿 板 狗 虎 狼 驢 馬 奶 片 權 獅 
回=來 答 去 家 到 頭 憶 國 想 信 轉 顧 復 廊 鄉 話 味 避 旋 響 音 聲 教 敬 首 報 歸 族 蕩 電 絕 民 合 扣 請 路 收 溯 屋 檔 彈 部 數 個 擊 爐 生 潮 程 訪 籠 暖 師 升 條 放 本 落 饋 穩 目 流 購 望 贈 了 過 事 春 眸 魂 應 天 援 文 車 身 鍋 傭 函 神 水 填 城 波 跌 傳 帖 禮 繞 歷 祿 念 稟 拜 駁 吃 腸 單 調 防 火 環 返 還 航 紇 鶻 護 府 見 交 空 口 門 聘 遷 青 贖 手 送 戲 翔 執 漲 嘴 抽 動 風 叫 人 授 絲 跳 退 
然=而 后 則 諾 乎 
明=白 天 年 顯 確 知 代 日 了 亮 兒 月 星 朗 媚 凈 快 珠 令 麗 晰 鏡 燈 理 晚 證 智 達 慧 澈 火 處 路 禮 扣 后 擺 碼 礬 暢 報 的 文 清 德 言 朝 道 教 末 示 說 光 辨 目 早 細 起 渠 治 暗 槍 定 將 政 春 人 輝 蝦 哲 史 艷 察 基 志 銳 里 補 晨 斷 黃 溝 鑒 君 潔 價 面 滅 眸 盤 前 搶 堂 線 曉 秀 喻 油 耀 杖 度 湖 膠 倫 仁 時 水 眼 州 
父=親 母 子 女 兄 老 輩 系 權 愛 本 業 王 職 執 
告=訴 辭 別 示 密 誡 狀 白 發 退 知 終 饒 急 慰 吹 警 捷 罄 之 破 人 假 成 勞 老 病 敗 便 貸 倒 負 官 竣 絕 缺 誦 送 語 罪 
有=些 點 的 時 所 趣 錢 事 關 力 名 著 意 用 限 益 理 如 心 余 效 數 害 利 為 神 生 功 待 方 形 機 色 底 軌 勞 碼 么 期 源 線 一 人 助 多 大 否 個 了 權 何 這 雨 無 小 信 新 此 霧 在 我 成 過 責 情 得 感 沒 你 賴 空 問 太 分 約 罪 別 志 極 位 售 異 違 種 毒 條 獎 損 對 天 幸 福 愛 法 之 病 緣 全 錯 家 聲 主 失 望 禮 清 性 變 話 氣 疑 加 云 日 長 序 車 若 喜 光 才 根 難 漏 答 因 風 血 誤 知 只 眼 靈 節 礙 染 間 邊 年 傷 路 銀 肉 味 德 案 救 致 勁 假 貨 鬼 恩 產 酒 啦 門 座 請 耳 刺 吃 仇 識 零 備 夢 嗎  舊 月 司 啥 素 閑 沒 戲 品 角 度 愧 兵 償 臉 盼 隙 孕 頃 鱗 誰 芽 嘴 悖 
眼=睛 光 淚 前 里 看 鏡 珠 皮 角 神 色 圈 眶 見 界 力 波 簾 目 底 熟 福 泡 瞼 球 熱 生 窩 眉 線 藥 瞅 癮 跳 科 罩 中 的 部 影 下 耳 內 疾 紅 花 孔 白 袋 眸 離 病 饞 岔 眵 點 黑 高 尖 快 淺 梢 屎 時 暈 壓 拙 臉 亮 炎 
人=家 民 們 物 生 類 心 間 格 和 情 事 才 群 員 口 性 兒 為 聲 士 叢 頭 力 道 世 手 數 名 中 種 大 命 品 體 馬 工 稱 流 像 海 身 緣 權 造 參 犯 文 跡 氏 望 選 倫 魚 煙 丁 質 均 猿 證 夫 腦 堆 設 禍 梯 的 是 氣 有 所 不 之 來 說 次 看 多 到 同 知 用 際 行 問 地 壽 治 本 潮 機 蛇 眼 時 意 少 語 妖 話 愿 肉 主 保 形 影 日 年 托 精 欲 老 脈 言 份 耳 畜 月 與 眾 字 防 寰 豪 杰 行  天 味 樣 藝 軋 樂 呢 浪 販 化 嗎 上 舞 學 渣 
于=是 維 逖 謙 
忽=然 而 略 視 地 閃 悠 米 見 律 聞 明 聽 
為=了 人 難 著 何 止 此 主 生 首 名 伍 期 由 憑 鑒 次 豪 恥 輔 一 本 我 準 你 他 例 有 學 這 其 您 大 高 使 數 她 公 低 多 最 國 題 的 之 對 佳 非 政 要 業 它 先 時 正 愛 用 民 美 家 那 證 限 己 能 善 樂 文 患 外 榮 副 情 師 王 甚 誰 女 后 妻 開 好 宜 利 敵 官 荷 界 害 伴 力 序 傲 夫 繼 戒 如 盼 啥 兄 重 長 綱 
過=去 來 頭 于 年 后 分 程 渡 度 錯 問 節 多 夜 火 道 人 失 路 時 慮 目 客 繼 剩 場 冬 敏 關 獎 細 秤 濾 期 戶 窄 億 隙 猛 寬 場 廳 量 硬 載 的 往 了 高 大 有 得 著 境 早 癮 長 熱 低 那 甚 活 江 世 數 半 小 好 電 急 氣 勞 橋 激 河 少 快 當 水 手 嚴 天 久 招 短 眼 街 話 心 完 緊 盛 門 冷 磅 從 兒 禮 淋 錄 訪 房 勁 謙 晌 篩 堂 望 午 夏 譽 逾 重 賬 飽 桿 濫 梁 熟 膝 
第=一 二 三 四 五 六 七 八 十 九 幾 宅 
太=陽 平 監 后 空 子 爺 祖 醫 原 守 學 公 廟 極 歲 君 爽 傻 妙 爛 寬 淡 史 婆 多 大 古 過 短 少 高 遠 快 好 長 久 和 郎 遲 小 差 低 慢 深 早 難 忙 強 累 貴 白 虛 緊 湖 急 細 不 有 熱 晚 近 愛 康 輕 冷 軟 美 淺 舊 硬 易 廣 保 師 上 沒 弱 厚 陰 飽 想 棒 濃 亂 俗 笨 雜 濫 老 餓 半 菜 胖 甚 尉 息 重 矮 暗 薄 吵 沖 丑 臭 煩 傅 谷 黑 狠 恨 壞 摳 苦 狂 懶 妹 猛 能 濕 瘦 松 彎 行 艷 油 臟 
聲=音 明 響 調 息 勢 浪 氣 譽 張 稱 韻 望 色 言 援 價 樂 討 帶 威 腔 母 門 學 中 聞 卡 名 道 波 效 寶 控 光 請 部 區 障 頻 壓 訊 源 納 律 辯 場 符 口 旁 譜 情 強 速 紋 像 域 揚 慢 碼 能 
咱=們 倆 倆 家 家 村 到 
下=去 來 午 面 車 雨 巴 手 文 等 落 山 次 鄉 流 邊 筆 令 水 地 場 層 垂 回 臺 賤 人 課 班 放 雪 降 行 沉 級 擺 屬 列 野 馬 旬 款 海 家 蛋 工 聯 方 輩 風 種 士 策 陷 榻 情 發 體 頜 顎 田 探 井 簽 簽 達 欠 帖 肢 設 棋 跌 集 位 限 載 一 頁 了 有 述 崗 調 月 周 個 圖 滑 期 半 學 挫 同 年 作 角 身 游 著 屆 生 任 編 過 樓 部 棋 單 第 拉 頭 盤 定 世 腳 廚 墜 線 篇 床 注 檔 嫁 機 凡 完 推 移 步 毒 拜 處 廠 壓 女 法 子 段 端 坡 關 網 操 唇 肚 腰 獄 市 品 腹 葬 錯 奶 里 力 輪 撥 乘 船 存 地 碇 店 刀 浮 飯 浣 房 懷 貨 跪 邽 疳 鍋 官 酒 江 焦 界 勁 頦 鋪 聘 氣 首 沙 神 剩 問 弦 泄 瀉 藥 院 咽 箸 詔 板 雹 標 側 臣 劃 痢 料 傾 書 土 晚 霧 旋 頷 
世=界 紀 間 人 故 事 家 俗 面 道 襲 代 態 交 情 兄 仇 風 相 衛 系 族 局 醫 貿 上 尊 外 變 傳 親 象 宗 伯 臣 嘉 行 子 
上=海 去 面 來 帝 下 學 前 午 課 次 山 等 岸 門 街 邊 述 臺 天 流 班 身 升 司 級 層 游 當 行 場 工 好 算 衣 文 演 書 空 路 風 手 回 端 陣 裝 士 進 任 市 諭 火 萬 品 座 馬 報 將 年 部 鉤 水 校 漲 家 癮 訴 聯 溯 聲 賓 款 映 策 相 峰 交 尉 調 訪 旬 蒼 稅 體 臂 闕 涌 翹 軌 腹 凍 告 焦 位 膘 繳 顎 漿 肢 的 一 頁 有 網 了 載 限 月 周 可 期 方 個 傳 列 車 很 證 新 香 分 角 人 堂 屆 高 至 乘 樓 床 揚 心 過 佳 首 頭 古 百 色 千 世 船 完 選 半 榜 達 億 鎖 機 線 集 供 簽 代 編 智 口 國 篇 眼 客 舉 站 院 官 移 吊 鏡 檔 油 緊 崗 段 京 唇 房 沖 樹 道 皮 光 思 操 卷 翻 貨 浮 菜 元 勁 屏 臉 籃 梁 輩 朝 蔟 頜 墳 浣 肥 綱 貢 江 鋪 坡 簽 色 網 膛 套 弦 鞋 刑 旋 藥 夜 賬 照 奏 蔡 燈 糞 杭 計 界 蠟 欄 壘 牌 拋 漆 饒 桅 席 溢 猶 釉 虞 桌 閂 
問=題 道 好 候 答 句 世 號 及 津 詢 罪 藥 出 鼎 卷 價 到 他 了 過 下 其 話 起 安 人 誰 路 事 訊 案 難 卜 看 心 住 診 斬 荊 明 
她=們 倆 的 是 又 有 就 將 能 家 
文=學 藝 章 化 字 人 明 壇 言 件 采 物 集 選 法 雅 革 筆 豪 憑 體 書 科 武 獻 稿 句 盲 聯 庫 言 具 才 官 理 思 苑 風 辭 史 教 靜 墨 娛 治 本 摘 牘 場 飾 卷 痞 傳 質 印 叢 碼 告 童 宗 責 玩 戲 職 竹 儈 中 員 林 華 檔 意 翰 萊 昌 義 慧 士 旦 號 類 王 藻 身 強 弱 案 丑 電 火 房 籍 秘 廟 脈 山 胸 秀 協 友 約 安 彬 成 登 定 斗 虎 匯 娟 料 論 契 石 水 萃 
說=話 是 道 明 來 法 笑 謊 服 定 教 理 和 唱 白 穿 情 動 罷 辭 你 他 過 出 得 到 有 不 起 對 完 與 著 中 愛 成 聲 些 清 上 給 好 吧 句 個 下 破 錯 開 文 合 詞 書 部 點 通 服 棋 事 客 口 媒 親 看 死 頭 戲 項 一 嘴 慣 您 
日=本 子 記 常 夜 光 報 月 期 文 益 頭 出 后 落 歷 用 語 漸 寇 間 趨 前 程 內 晷 照 心 顯 版 食 產 場 托 下 圓 劇 中 立 式 志 數 經 表 軍 韓 元 新 來 均 刊 見 美 進 線 方 久 曬 華 薪 創 工 壇 商 影 夕 貨 珥 里 流 班 斑 戳 ? 化 冕 暮 色 暈 雜 臻 你 輪 神 息 增 
小=說 姐 孩 心 時 子 學 人 事 寒 兒 品 鳥 腳 鬼 報 河 路 米 看 組 販 名 溪 弟 徑 刀 道 褂 引 氣 生 字 錢 巧 型 帽 曲 節 腿 雨 費 康 偷 丑 傳 調 毛 便 菜 商 辮 車 工 指 吃 春 卒 旦 站 鑼 麥 楷 國 將 說 姑 隊 戲 輩 艇 雪 鞋 照 憩 子 注 葉 于 粉 令 我 影 帳 號 腸 區 班 豆 農 灶 蔥 札 碗 攤 獸 雀 臉 技 床 臂 僧 姓 胖 薇 篆 詞 戶 數 腹 腦 結 嗓 娃 樣 咬 童 六 的 巴 公 食 女 西 島 冊 三 熊 泉 幅 妹 額 狗 花 二 白 屋 計 布 鎮 貓 明 記 山 魚 量 寶 龍 手 豬 乘 圖 玲 強 船 城 草 火 盤 馬 塊 孔 可 村 雞 星 蜜 海 水 聚 巷 金 覷 包 羊 聲 牛 美 華 樹 林 書 點 房 圓 店 新 嘴 鳳 橋 球 語 有 云 室 史 步 器 段 圈 洞 王 鹿 舌 鷹 英 平 片 李 虎 蟲 過 粒 梅 風 病 的 兔 角 睡 鴨 命 詩 成 試 兵 股 利 門 半 鼓 珠 窗 鼠 惠 坑 寫 舅 年 綹 鯢 囡 別 霸 處 炒 差 產 潮 疵 芳 伙 紡 官 柜 解 件 建 襟 盡 家 開 考 賣 滿 跑 瞧 秋 視 市 暑 頭 修 月 衣 姨 洋 資 坐 住 酌 舟 宗 崽 編 翠 安 板 本 邊 變 廠 巢 池 錯 袋 滴 東 堆 方 富 剛 港 哥 溝 鍋 盒 湖 環 會 薊 間 街 井 居 口 捆 吏 梁 陵 籠 樓 呂 錨 苗 民 棚 瓶 仆 旗 丘 犬 蛇 獅 叔 穗 孫 塔 跳 桶 灣 婉 巫 蝦 箱 項 穴 雅 眼 妖 議 飲 勇 院 章 張 枝 種 柱 桌 廝 妞 
別=人 的 說 扭 墅 離 提 致 號 名 針 字 稱 集 用 忙 慌 跑 趣 為 在 具 有 無 忘 處 再 讓 是 了 傳 國 把 來 被 問 上 想 看 去 后 家 怕 論 開 戀 哭 急 體 派 裁 管 情 史 緒 樣 子 嘴 猜 吵 動 干 館 克 拿 鬧 笑 住 著 
社=會 交 員 論 稷 戲 團 辦 址 評 區 群 工 科 教 長 隊 火 情 保 刊 旗 
希=望 臘 冀 爾 求 捷 圖 
多=少 么 數 年 半 久 次 情 謝 余 心 時 嘴 種 頭 方 寡 樣 掙 妻 聊 繳 厚 爾 不 糖 邊 級 價 的 個 人 項 了 利 位 元 名 些 于 有 用 萬 是 月 大 事 達 為 點 家 在 層 歲 重 國 加 款 做 處 條 說 變 宗 新 部 云 得 出 好 面 吃 看 日 天 會 花 姿 張 億 想 如 問 角 讀 篇 臺 高 到 講 見 給 德 選 長 病 彩 賺 受 能 收 發 疑 言 聞 難 產 字 相 倍 話 等 向 遠 才 科 斗 鱗 米 雨 管 則 起 山 空 得 咱 禮 餐 交 道 指 義 快 汁 哈 虧 強 辦 量 端 哥 打 孔 維 節 練 音 圖 列 慮 倫 極 嬌 占 刺 風 晶 抗 寬 拉 倫 毛 夢 石 霜 箱 雪 載 枝 脂 值 子 ? 
完=全 了 成 美 整 事 結 畢 工 善 備 好 人 滿 蛋 小 稿 稅 竣 了 糧 敗 婚 聚 勝 戲 形 鉆 璧 
工=作 夫 人 廠 具 會 錢 業 程 資 地 農 友 藝 場 商 事 整 潮 匠 細 頭 兵 筆 科 巧 余 力 時 薪 房 楷 賊 價 礦 料 齡 棚 序 本 架 穩 致 尺 分 期 務 聯 學 貿 運 傷 部 種 委 頻 黨 專 于 件 讀 段 交 行 日 殘 蜂 間 卡 區 亡 休 效 蟻 役 長 裝 拙 況 體 質 
學=生 校 習 者 問 會 堂 術 院 說 識 士 徒 位 費 期 界 好 理 派 業 監 風 人 究 員 科 藝 子 名 府 社 力 潮 長 年 塾 友 分 歷 童 報 時 制 棍 籍 部 閥 齡 武 畫 案 舌 刊 的 系 到 額 園 前 家 聯 得 了 過 海 成 法 運 號 文 來 道 苑 醫 養 去 起 區 工 壞 完 妹 點 步 霸 館 具 銜 星 誠 級 姐 軍 琴 如 舍 樣 政 
意=思 見 義 識 外 志 味 料 境 氣 念 旨 象 圖 向 緒 會 匠 興 趣 愿 欲 即 指 在 謂 亂 譯 下 中 態 表 甲 想 淫 蘊 切 動 面 為 文 
作=品 家 者 為 用 文 成 出 戰 風 主 畫 怪 客 法 對 伴 證 惡 罷 業 協 弄 坊 祟 嘔 弊 陪 難 亂 曲 物 保 廢 梗 價 料 派 序 案 圖 答 準 大 詞 聲 息 樂 假 別 痛 響 些 勢 詩 美 秀 孽 賤 臉 伐 古 數 色 死 態 偽 興 揖 俑 樂 
之=后 中 間 下 一 外 類 前 上 際 內 舟 遠 異 誼 也 小 象 夏 味 嘆 書 橋 強 念 謀 面 龍 魂 會 花 材 敗 安 劍 都 怒 相 最 處 用 余 旅 道 二 時 友 家 地 三 人 四 五 多 日 路 事 行 心 名 聲 意 列 情 夜 大 星 作 王 分 初 權 子 爭 門 久 勢 苦 美 嫌 文 物 于 說 冠 謎 稱 母 法 首 感 故 本 言 神 光 主 手 高 士 力 戰 徒 源 父 風 歌 學 義 理 交 樂 別 長 比 舉 差 身 流 氣 年 窗 謂 便 見 功 愛 極 過 水 計 機 女 憂 國 始 輩 音 境 虞 邀 色 罪 需 好 妙 末 恩 深 迷 術 隔 至 責 痛 體 珠 策 約 舞 夢 論 鄉 靈 師 害 眾 難 喜 口 亂 語 君 詞 尊 才 辭 誤 遙 春 秋 夫 危 想 巔 災 妻 勇 恨 邦 濱 勞 巨 隊 重 和 旁 險 
應=當 該 酬 有 付 用 得 聲 對 驗 戰 試 邀 允 答 承 急 景 征 聘 考 變 納 急 力 診 以 是 否 為 盡 由 將 許 予 于 能 從 按 收 受 訴 了 屆 負 選 物 知 分 給 繳 制 接 道 召 節 明 時 和 門 約 市 手 舉 運 諾 城 敵 典 卯 募 拍 山 縣 援 招 須 份 
后=來 面 悔 邊 天 者 門 人 方 記 代 世 臺 影 退 期 果 母 起 事 裔 生 進 身 跟 腿 援 輩 腳 任 盾 話 路 背 媽 腦 襟 患 塵 年 娘 送 備 勤 撤 街 窗 妻 手 續 帳 步 勁 的 有 又 會 市 由 不 補 到 因 心 加 繼 上 于 防 座 排 半 衛 學 巷 山 日 段 輪 行 主 尾 景 部 知 置 嗣 端 場 院 頭 頸 兒 梁 艙 燈 爹 父 妃 福 漢 房 宮 顧 金 晉 昆 怕 晌 首 廈 唐 魏 序 效 項 羿 腰 綴 賬 肢 周 軸 傳 蓋 冠 集 橋 區 堂 膛 庭 桅 園 緣 爪 足 
當=然 時 作 真 初 年 地 著 面 局 中 兒 前 天 差 兵 代 心 日 場 成 鋪 眾 家 今 頭 晚 夜 即 權 選 歸 道 票 政 推 關 量 我 你 值 您 上 下 是 為 在 紅 過 機 個 月 街 庭 得 世 此 事 先 緊 空 官 好 令 啷 班 朝 賣 堂 途 午 央 腰 院 子 掉 間 口 涂 雄 陽 
北=京 平 方 海 大 風 邊 斗 部 面 國 美 歐 極 非 冥 通 緯 辰 角 區 市 移 韓 上 的 約 路 岸 宋 至 一 亞 地 伐 投 段 魏 南 島 山 江 端 朝 門 麓 碚 側 貨 航 漢 虢 瓜 疆 郊 齊 曲 圖 頭 影 洋 周 安 房 流 能 票 去 援 岳 站 
樣=子 式 本 板 品 片 書 張 款 做 貌 兒 稿 機 件 車 冊 刊 條 
喜=歡 愛 悅 劇 事 酒 氣 鵲 色 訊 慶 好 幛 聯 娘 報 遷 惡 筵 果 錢 人 雨 樂 怒 獲 得 宴 迎 惡 帖 蛋 看 喪 糖 聞 興 幸 盈 力 
思=想 索 潮 考 念 路 慮 維 量 緒 慕 鄉 變 謀 戀 辨 科 源 親 忖 春 凡 過 古 歸 舊 茅 摸 情 君 恩 
仿=佛 效 照 古 造 制 宋 單 真 冒 若 辦 建 生 行 影 紙 
真=是 正 實 理 話 誠 心 摯 相 個 切 情 人 意 假 知 諦 格 跡 空 讓 怕 靈 彩 笨 乃 巧 牛 早 少 強 爽 果 性 主 品 書 釋 的 確 愛 好 偽 想 身 我 能 不 如 皮 菌 像 言 絲 金 快 難 傳 經 多 夠 兇 沒 值 臭 容 率 棒 純 逗 壞 數 行 影 貨 累 傻 事 髓 糟 
想=到 起 來 法 必 念 看 象 見 頭 坐 了 歪 要 過 在 做 問 去 找 著 你 買 了 說 看 出 把 用 同 學 從 盡 聽 好 打 玩 走 哭 通 開 死 愛 些 睡 一 家 笑 逃 喝 望 他 錯 定 
能=夠 力 干 否 耐 事 量 手 動 人 侃 指 源 在 有 為 使 與 將 把 對 用 不 及 說 做 見 帶 打 學 走 開 上 行 當 吃 變 不 者 耗 級 效 譯 
得=到 了 出 意 罪 失 以 體 知 救 勝 力 當 法 志 手 勁 勢 分 數 寵 益 要 逞 很 多 獎 悉 來 主 過 起 見 閑 票 住 人 利 名 由 道 虧 用 榮 時 病 理 空 點 便 標 計 濟 幸 慌 
愿=意 望 心 同 出 你 景 將 為 書 
辦=法 事 公 理 到 案 學 廠 的 了 好 妥 得 成 報 證 班 復 貨 結 罪 刊 起 
實=在 際 現 行 話 踐 用 驗 業 力 事 情 地 習 例 質 況 物 證 施 惠 權 效 體 干 心 足 益 彈 據 像 打 數 招 職 測 字 時 務 有 屬 為 錄 戰 無 則 景 感 型 價 收 績 乃 木 利 學 落 處 誠 詞 根 名 說 生 意 軸 參 達 寄 鉀 勁 拍 線 樣 癥 幟 
永=遠 不 久  別 訣 世 生 康 安 樂 泰 昌 興 豐 在 存 和 德 續 順 年 平 仁 寧 春 勝 嘉 新 福 善 碩 葆 磁 眠 逝 夜 駐 城 川 登 定 吉 濟 歷 清 壽 修 志 中 州 
十=分 月 萬 足 字 翼 戒 方 五 一 二 八 三 四 六 年 七 九 日 多 時 個 歲 大 億 條 幾 天 位 號 點 次 周 章 屆 種 倍 米 秒 張 載 指 家 誡 來 篇 里 首 件 層 級 斤 國 成 佳 全 堰 杯 惡 發 克 強 升 
青=年 春 島 山 天 蛙 草 菜 色 苔 翠 衣 筋 石 松 綠 灰 白 海 云 銅 燈 鳥 花 梅 聯 絲 蛇 史 果 衫 黃 魚 苗 豆 稞 蝦 瓷 椒 少 睞 蔥 龍 瓜 貯 田 州 玉 澀 藍 工 樓 蓮 幫 黛 蚨 蒿 岡 衿 麻 皮 蒜 童 葙 眼 ? 鼬 藏 紫 冢 川 峰 河 家 浦 神 檀 瓦 縣 煙 陽 葉 蠅 竹 鱸 
聽=見 到 說 眾 從 講 筒 取 憑 候 覺 信 便 任 雨 膩 潮 力 過 了 聞 得 歌 完 音 著 話 來 者 證 出 課 那 寫 懂 錯 命 清 書 差 海 喝 會 骨 客 審 事 訟 聲 順 戲 閾 一 裝 政 診 子 打 慣 誰 頭 
進=來 去 步 行 入 城 化 攻 展 士 出 而 取 退 口 軍 款 修 程 項 言 逼 發 益 餐 犯 食 酒 戶 過 度 深 駐 兵 貨 階 了 場 帳 到 諫 門 占 位 京 學 屋 料 水 香 補 貢 制 港 宮 賬 校 身 站 營 瑞 路 讒 尺 呈 抵 奉 境 見 擊 剿 球 山 壇 獻 賢 針 廠 刀 洞 給 價 紙 
非=常 洲 但 人 難 徒 法 議 標 凡 禮 經 要 因 我 公 得 同 也 獨 分 比 婚 得 典 命 笑 刑 門 去 
里=面 頭 邊 外 帶 子 弄 手 脊 圈 程 根 的 昂 去 人 拉 屋 長 約 斯 層 海 間 外 巷 加 來 氏 水 弦 
革=命 新 職 除 囊 履 出 
容=易 忍 許 納 貌 顏 量 器 止 積 錯 讓 下 抗 身 人 留 得 光 情 重 城 色 恕 膝 幸 
關=系 于 心 切 懷 門 鍵 閉 頭 注 聯 照 節 稅 口 押 山 防 子 卡 過 窗 隘 的 乎 機 上 掉 顧 愛 島 人 員 進 公 西 中 貿 起 羽 入 燈 東 外 礙 內 店 津 緊 塞 涉 說 停 銜 廂 餉 張 里 雎 渡 著 
發=表 生 現 展 出 明 達 言 財 揮 起 動 光 愁 笑 行 泄 抖 作 亮 覺 燒 熱 狂 怒 瘋 問 紅 育 揚 掘 慌 呆 音 誓 給 源 髻 聲 狠 射 芽 布 自 火 跡 落 霉 胖 炎 還 麻 電 憤 酵 福 令 痧 送 端 臭 放 奮 售 病 稿 毛 票 難 榜 汗 配 型 糕 網 面 飆 痛 梢 去 涼 件 號 好 春 顫 怵 妻 球 文 夾 獎 排 條 簪 報 貨 家 卡 蠟 情 的 牌 了 信 證 帖 愣 威 愿 點 到 回 成 廊 白 過 功 來 物 絲 散 黃 際 下 炮 菜 冷 薪 黑 軟 指 函 祥 式 往 飄 蔫 懶 案 藍 力 軔 辮 包 標 兵 錯 車 潮 癡 ? 堵 嗲 昏 話 花 橫 凡 粉 付 行 紺 窘 急 賤 膠 緊 棵 困 刊 苦 蒙 墨 悶 木 氣 酸 喪 傻 身 抒 水 澀 套 屋 虛 噱 餉 運 暈 癢 脹 怔 紫 暗 喘 帶 根 乎 價 結 料 露 綠 青 刷 燙 癬 硬 油 疹 腫 
如=果 此 何 今 同 下 意 其 故 實 若 愿 上 數 常 期 織 泥 假 約 有 欲 在 需 要 是 能 一 想 水 不 獲 因 來 與 未 遇 前 為 用 圖 夢 斯 火 廁 心 新 法 雨 潮 風 畫 飛 山 東 鏡 詩 花 神 云 雪 入 雷 昔 初 舊 命 題 玉 月 許 麻 次 弟 梭 兄 象 字 蔥 皋 劍 霜 絲 霧 血 煙 注 
高=興 聲 大 明 尚 貴 級 等 山 低 度 粱 樓 雅 升 中 舉 深 傲 峰 潮 唱 超 聳 下 呼  空 漲 祖 層 攀 歌 亢 僧 喊 地 原 論 人 手 潔 齡 小 壓 見 妙 價 燒 矮 位 調 干 帽 峻 考 音 坡 壽 昂 強 蹺 射 速 招 工 寒 枝 談 抬 格 溫 腔 校 足 產 爐 熱 徒 效 薪 利 能 湯 雄 云 的 達 于 出 官 企 院 處 一 危 風 球 過 階 分 飛 息 額 開 三 斯 估 士 密 職 新 頻 檔 臺 架 掛 踞 教 懸 麗 叫 二 要 居 脂 邁 燥 程 就 挑 遠 買 端 安 年 宗 照 佬 胡 腳 師 發 清 難 露 倍 參 才 矗 楓 虎 閣 個 看 慢 門 名 聘 炮 擎 爽 堂 揚 知 枕 走 會 差 擋 法 鋒 桿 崗 的 地 根 家 檢 節 亮 陵 盧 棉 平 翹 青 瘦 壇 唐 通 頭 翔 崖 陽 邑 郵 州 奏 
或=者 是 許 被 用 非 稱 缺 請 曰 然 則 
感=到 情 覺 謝 動 激 想 慨 受 觸 應 冒 嘆 人 化 染 官 恩 性 召 知 電 光 言 悟 觀 奮 懷 傷 念 紉 戴 憤 喟 愧 抗 佩 世 概 荷 生 
慢=來 性 車 牛 點 耗 等 的 火 速 步 跑 磨 得 班 詞 待 發 件 地 坡 走 地 化 咽 
公=示 司 園 館 開 寓 平 共 事 路 主 債 道 理 使 元 然 民 子 報 文 正 眾 式 案 家 布 認 安 婆 里 尺 社 益 私 德 務 例 款 會 堂 論 費 函 演 敵 有 產 憤 差 法 斤 干 審 推 物 房 歷 墓 意 仆 斷 人 約 章 關 害 頃 比 證 擔 告 判 心 職 分 國 海 糧 營 仔 署 用 帑 立 升 噸 爵 允 車 牛 交 映 訴 廁 所 信 地 畜 投 雞 余 轉 決 羊 孫 器 娼 了 厘 良 鹿 辦 測 出 稱 爹 侯 賄 假 舉 祭 孟 畝 派 卿 輸 傷 攤 網 休 廨 議 冶 制 助 秉 拆 寸 撮 斗 而 毫 價 庫 馬 賣 門 汽 錢 權 勺 石 兔 鴨 引 丈 豬 族 
其=實 中 他 余 次 間 一 它 二 后 所 內 時 父 人 職 妻 名 意 外 三 下 用 文 言 害 境 解 先 四 
特=別 殊 務 點 意 地 色 有 征 性 權 為 大 長 刊 約 使 此 制 定 產 寫 種 派 等 出 輯 設 工 價 例 效 區 教 好 級 技 警 赦 委 邀 指 首 質 惠 許 快 稿 遣 強 賣 高 告 多 將 異 號 準 佳 聘 來 困 任 護 化 供 急 命 批 貧 勤 曲 體 需 向 嫌 優 藥 醫 招 診 案 典 鋼 解 里 立 免 納 型 作 
同=時 志 學 情 樣 意 一 事 胞 鄉 伴 行 年 居 上 盟 聲 類 等 船 化 感 路 道 性 心 黨 業 輩 伙 僚 步 謀 歲 窗 調 期 屋 遭 室 村 城 屏 在 比 住 樂 日 級 為 好 臺 儕 仁 名 月 組 體 班 游 去 齡 系 門 來 享 價 房 出 理 義 下 案 機 校 質 軸 往 根 源 歸 音 車 治 創 文 歡 氣 堂 濟 犯 當 父 生 型 床 種 安 唱 族 相 德 科 姓 點 方 桌 慶 玩 問 行 庚 構 母 前 求 喜 謝 宗 吃 此 格 賀 江 量 素 態 位 溫 形 
要=是 求 緊 不 人 好 命 強 點 得 飯 素 事 么 害 挾 沖 領 道 犯 件 義 塞 價 職 聞 津 略 端 員 地 目 貨 官 圖 務 旨 案 路 子 則 的 在 有 用 做 把 將 以 到 去 向 多 看 使 從 讓 說 找 你 走 來 給 學 想 比 問 考 大 帶 按 打 講 訣 付 受 吃 回 寫 死 數 像 小 見 快 活 殺 約 辦 錢 就 賣 干 喝 項 管 決 少 抓 嫁 位 罰 隘 臉 不 謊 言 賬 覽 
精=神 力 明 致 彩 美 細 巧 密 華 通 心 光 靈 確 煉 到 裝 悍 辟 練 選 深 妙 干 壯 簡 品 粹 銳 髓 制 怪 良 液 英 湛 當 讀 兵 編 蟲 瘦 進 于 子 要 舍 算 紡 度 工 義 煤 微 準 油 研 氣 誠 囊 肉 本 博 白 純 赤 巢 魂 耕 講 潔 礦 奇 審 熟 衛 鹽 忠 專 奧 餾 梳 武 一 汁 
身=上 體 子 邊 后 材 旁 份 量 心 世 軀 段 受 價 手 影 長 高 形 家 亡 孕 染 披 條 教 姿 為 處 穿 在 兼 前 故 陷 患 無 外 居 懷 法 負 歷 板 架 重 著 殘 臨 下 
故=事 意 鄉 宮 人 國 都 此 居 里 態 園 土 城 址 交 地 曰 弄 宅 障 道 智 友 在 我 名 而 作 稱 實 知 老 舊 常 伎 去 世 殺 書 吏 紙 
總=是 算 之 理 長 統 務 結 督 歸 共 管 數 部 計 裁 集 體 和 局 括 目 站 稱 量 署 值 攻 兵 對 功 重 找 臺 說 怕 給 該 把 帥 綱 機 隊 額 匯 編 攬 評 會 監 有 成 辦 要 分 覽 比 不 價 第 表 愛 則 論 的 支 能 線 合 店 得 工 社 產 廠 裝 行 參 后 角 譜 圖 校 賬 政 章 
必=須 定 要 然 需 得 將 修 備 糾 中 會 有 能 先 讀 究 勝 經 殺 死 看 答 敗 爭 學 
兒=子 童 女 媳 孫 戲 歌 馬 科 時 化 郎 男 茶 
常=見 識 用 人 態 務 事 熟 言 規 年 情 客 會 州 理 軌 委 川 例 新 昊 備 有 在 說 以 開 設 到 住 把 任 駐 樂 去 談 綠 數 可 德 青 飲 來 吃 山 量 服 衡 寬 套 溫 性 喝 價 禮 寧 勝 往 
開=始 口 會 門 眼 頭 心 放 水 車 花 除 明 槍 辟 幕 張 銷 學 發 飯 展 工 朗 船 動 刀 闊 路 通 火 端 場 導 封 支 設 演 進 關 國 礦 拓 炮 化 羅 戰 拔 辦 市 脫 間 恩 啟 創 荒 墾 采 方 課 列 山 業 篇 道 盤 竅 胃 掘 腔 講 庭 赴 胸 建 購 服 拍 鑿 齋 禁 外 航 本 豁 賽 征 了 的 出 戶 鑼 立 大 機 去 店 價 來 班 著 懷 示 到 源 往 解 獎 審 平 局 元 步 光 過 合 窗 悟 具 打 坯 鎖 行 走 館 票 房 地 播 上 鉆 臺 球 罪 燈 下 金 卷 帖 罵 履 裂 顱 犁 例 臉 灤 溜 標 閉 遍 春 衩 秤 初 鋤 凍 吊 付 河 葷 伙 革 鍋 架 膠 鏡 戒 街 交 襟 擴 蒙 排 衫 釋 哨 涮 說 膛 題 挖 線 先 戲 印 顏 言 洋 映 園 營 閘 仗 診 綻 賬 筵 苞 筆 槽 城 單 洞 溝 環 江 據 快 曠 爐 滿 屏 缺 刃 入 停 箱 向 陽 原 遠 早 狀 嘴 闔 
屋=子 頂 角 檐 脊 面 梁 瓦 架 宇 內 中 外 主 里 舍 后 門 
正=在 是 如 好 要 經 確 式 當 義 面 常 中 月 直 統 氣 色 事 視 路 派 值 道 房 文 題 音 史 規 屋 門 廳 教 軌 法 理 書 本 話 身 方 告 果 太 欲 愁 字 旦 極 劇 楷 業 比 餐 數 座 步 負 論 片 切 梁 體 弦 職 的 與 為 版 向 宗 午 選 反 被 想 以 副 和 對 名 東 大 途 待 像 邪 牌 畸 德 人 忙 安 定 日 巧 心 手 逢 西 言 南 酣 處 北 茬 出 傳 冊 點 電 殿 犯 號 割 宮 骨 高 解 據 交 課 品 橋 室 誤 席 項 兇 眼 打 光 紅 火 取 聲 生 盛 壓 鹽 陽 則 轉 
晚=上 飯 報 餐 年 霞 會 風 輩 秋 景 車 期 節 點 宴 婚 班 稻 場 間 的 裝 了 膳 清 安 育 些 到 睡 霜 歸 娘 戀 春 潮 近 境 課 熟 生 世 唐 造 禱 來 歲 
本=來 人 身 事 領 地 能 子 國 質 文 意 錢 性 色 家 分 紀 位 刊 體 該 著 原 報 相 名 題 當 土 行 心 部 科 息 戲 義 源 字 末 利 官 群 職 金 港 會 校 年 月 頁 站 書 周 屆 期 是 已 院 欄 底 次 條 區 篇 田 應 社 片 章 想 可 店 案 票 季 業 無 市 版 節 系 園 級 主 生 臺 我 隊 然 省 機 項 日 劇 草 族 價 類 愿 村 島 旨 州 鄉 廠 帖 壘 幣 埠 冊 籍 色 訴 嗓 縣 溪 真 證 山 不 場 黨 兒 宮 里 輪 堂 套 鎮 座 
相=信 當 同 干 片 反 聲 見 對 識 貌 互 似 傳 差 處 比 近 思 關 遇 宜 距 愛 繼 通 等 隔 逢 會 應 公 仿 連 好 容 接 知 投 交 符 約 機 抵 持 勸 鄰 商 加 系 濟 逼 背 位 冊 乘 切 若 撞 聚 較 戀 助 配 熟 依 中 合 稱 向 伴 違 隨 擁 待 異 輔 爭 去 聯 親 生 紙 士 與 告 間 成 救 望 送 認 顧 離 左 克 悖 斗 報 看 框 迎 許 讓 承 吸 安 里 擾 幫 斥 除 煩 國 減 面 瞞 馬 撲 碰 術 書 視 托 態 形 沿 映 悅 并 別 攜 變 打 混 角 命 守 談 圖 諧 移 責 捋 
注=意 視 重 定 釋 解 目 射 明 入 腳 冊 文 銷 上 資 音 滿 水 色 油 
到=底 處 家 手 來 達 頭 會 場 期 點 頂 任 位 職 貨 了 訪 時 那 港 過 老 校 死 外 哪 臨 尾 晚 站 岸 里 案 庭 齊 京 
木=蘭 刻 頭 匠 板 棍 器 偶 材 瓜 料 船 筏 橋 版 床 魚 工 樁 炭 柱 棒 雕 排 香 柴 梳 耳 蓮 棉 馬 子 棚 有 本 星 質 筆 塊 屑 屋 制 門 箱 盆 樨 琴 人 桶 屐 條 訥 柜 然 欄 籠 叉 鐸 簡 槿 漿 片 薯 柵 栓 匣 ? 枕 ? 缽 桿 杠 雞 箭 劍 節 精 筷 框 梁 林 盤 塞 石 髓 瓦 楔 鞋 椅 賊 槌 簫 
微=笑 風 弱 妙 光 小 波 薄 細 詞 賤 粒 幅 閉 合 型 分 觀 量 軟 雨 升 的 言 調 米 塵 克 機 的 縮 星 安 利 瀾 坌 雕 服 火 距 刻 末 秒 明 碼 行 震 涼 冷 語 凹 白 差 顫 帶 動 開 孔 露 胖 翹 少 酸 克 張 皺 醉 恙 醺 蹙 
最=后 初 好 近 為 先 終 低 佳 矮 暗 丑 蠢 毒 夠 恨 酷 累 冷 靈 妙 淺 巧 瘦 松 甜 晚 鮮 香 兇 硬 圓 糟 重 響 負 純 帥 爽 逗 新 高 大 多 少 愛 早 快 有 具 強 令 長 能 小 差 深 短 想 難 怕 前 美 優 適 遲 上 貴 壞 不 輕 富 慘 熱 弱 廣 嚴 遠 下 平 忌 緊 紅 薄 讓 全 準 慢 久 值 棒 老 末 亮 右 左 窮 會 忙 乖 缺 
藝=術 人 苑 界 名 員 林 壇 校 文 能 品 齡 德 妓 徒 專 
姑=娘 母 媽 爺 且 嫂 子 丈 表 夫 息 舅 婆 寬 蘇 
認=識 為 真 得 出 清 定 錯 字 輸 命 可 罪 購 領 同 知 股 證 人 了 捐 罰 明 親 生 頭 養 賬 準 作 路 賠 做 
情=形 感 況 緒 人 景 節 愿 調 理 勢 面 趣 報 書 懷 意 欲 境 婦 分 愛 歌 話 事 敵 誼 詩 操 態 侶 思 由 義 網 夫 結 牽 緣 迷 深 有 真 色 變 場 狀 急 史 愫 味 仇 種 商 郎 癡 絲 殺 死 性 系 韻 致 知 切 怯 
衣=服 裳 袋 襟 食 料 冠 衫 角 箱 領 袖 架 著 櫥 飾 物 裝 鉤 柜 兜 扣 帽 錦 簍 缽 履 褲 擺 包 胞 長 帶 裙 魚 蛾 夾 肩 刷 
馬=上 路 車 褂 虎 克 蹄 達 背 戲 頭 褲 桶 夫 匹 列 力 甲 腳 鞍 靴 隊 蜂 蘭 槍 燈 廄 圈 前 堡 刀 賊 掌 駒 術 鬃 年 場 可 賽 祖 丁 仔 太 拉 刺 來 房 龍 約 利 尾 槽 弁 糞 倌 臉 兒 鞭 里 勒 兵 山 家 步 季 偕 藍 藺 陸 料 鹿 奶 幫 表 鱉 道 鐙 店 號 赫 竿 架 快 棚 屁 趴 球 鐵 熊 躍 子 扎 鈺 邊 公 關 后 具 累 尿 皮 群 肉 勺 首 嘶 醫 衣 蠅 謖 
記=得 者 憶 載 住 錄 事 性 述 號 掛 過 敘 仇 取 分 下 起 著 在 名 成 入 錯 協 數 賬 誦 牢 恨 功 工 譜 筆 法 日 時 
歷=史 代 來 年 程 書 任 時 法 次 經 屆 險 久 盡 世 練 本 朝 陳 數 覽 
哪=里 兒 個 怕 些 樣 邊 條 是 篇 還 管 一 種 有 位 去 家 類 來 天 年 能 敢 支 知 吒 國 會 
成=為 功 立 績 就 熟 天 人 員 分 長 見 語 年 群 果 名 心 全 家 敗 本 親 事 效 衣 交 材 文 婚 仁 因 法 例 才 冊 數 規 片 災 風 色 品 說 算 方 活 批 倍 命 約 蟲 藥 了 日 龍 真 佛 行 形 書 型 像 對 性 套 千 雙 百 癮 萬 仇 仙 章 殮 不 都 堆 丁 服 化 句 塊 礦 寐 眠 癖 器 趣 俗 宿 夜 議 昆 安 串 鳳 核 教 誦 體 團 武 箱 竹 組 
將=來 軍 要 近 就 士 領 官 帥 令 校 會 于 在 有 由 可 其 之 是 為 不 對 被 與 一 它 使 從 達 我 你 成 她 至 盡 相 把 死 臨 屆 門 才 次 息 養 暮 兵 材 
國=家 民 王 內 際 文 外 人 事 貨 粹 學 難 旗 土 語 會 度 防 書 恥 慶 有 體 史 魂 籍 情 畫 務 法 都 故 運 產 歌 境 界 術 門 君 殤 策 勢 名 教 庫 力 號 營 寶 葬 手 醫 賊 政 藥 徽 威 本 格 花 字 計 母 音 債 別 樂 鳥 色 泰 企 榮 立 華 中 強 大 電 小 權 腳 父 公 信 光 貿 風 標 軍 道 是 共 航 稅 舅 戚 三 賓 與 師 富 柄 辦 仇 典 劇 面 脈 球 喪 帑 璽 優 宴 幣 定 發 府 紀 旅 罵 平 宅 
幾=乎 時 何 組 支 眼 希 臺 絲 圈 起 瓶 縷 腳 筆 兆 集 級 趟 個 年 天 多 十 位 點 次 日 種 句 百 項 經 家 分 條 萬 千 近 大 歲 件 只 張 下 類 步 人 許 秒 倍 場 度 份 篇 番 段 代 億 塊 可 處 遍 月 回 樣 片 顆 歷 周 節 座 根 所 米 招 元 道 層 率 畝 封 案 把 曾 比 兒 號 屆 斤 兩 枚 尼 批 夜 站 鈿 
表=示 現 情 演 面 妹 哥 姐 達 明 嫂 弟 白 揚 格 彰 親 決 里 叔 述 露 侄 率 態 冊 象 舅 征 層 鏈 記 報 皮 字 帶 針 內 中 功 意 語 頭 ? 尺 姑 盤 土 兄 廠 袋 單 蓋 觀 殼 形 姨 音 姊 
機=會 關 器 械 構 智 靈 警 場 槍 緣 制 密 能 心 敏 車 遇 要 件 體 謀 尾 頂 身 油 子 動 頭 床 電 房 票 群 師 宜 翼 杼 艙 時 載 上 種 內 員 中 一 型 組 殼 箱 位 座 理 井 具 運 變 播 窗 鋒 耕 庫 米 巧 務 修 芯 繡 譯 長 織 柜 化 徽 降 首 臺 軸 
除=了 非 去 掉 外 名 草 以 夕 卻 惡 此 法 息 冰 盡 臭 害 開 蟲 錯 舊 根 數 日 弊 塵 服 號 權 喪 濕 夜 磁 垢 怪 魔 霜 
至=于 少 今 多 此 親 上 好 友 交 強 愛 為 高 尊 日 真 正 死 深 德 圣 公 極 善 寶 誠 理 遲 情 囑 點 福 
即=使 刻 便 將 日 位 時 令 席 興 景 可 是 在 為 以 成 用 被 會 與 能 把 告 食 今 到 行 逝 應 或 期 達 死 若 如 事 墨 
原=來 因 諒 文 則 始 先 有 本 名 理 稿 意 作 料 子 野 籍 形 著 定 地 樣 人 狀 色 位 版 告 委 主 價 物 址 配 型 貌 義 想 系 體 帖 畫 件 話 油 蟲 點 是 創 裝 聲 產 訂 素 味 罪 載 在 屬 判 審 處 礦 鹽 生 訴 汁 唱 木 案 詞 初 封 鴿 雞 煤 麻 毛 蜜 棉 圖 湯 田 液 職 紙 種 注 基 漿 糧 路 書 陽 質 宥 
決=定 不 心 計 非 裂 議 斷 意 然 戰 策 勝 口 賽 算 斗 無 出 一 絕 堤 死 
跟=著 前 隨 頭 進 蹤 班 手 腳 我 他 你 從 上 風 人 在 誰 帖 包 差 斗 梢 
從=前 來 此 小 事 容 頭 而 未 新 中 今 軍 速 嚴 政 屬 緊 師 業 藝 犯 句 權 不 這 一 他 沒 那 人 我 上 實 旁 眾 你 外 后 商 內 下 早 西 左 化 略 母 簡 南 先 良 影 輕 俗 江 戎 緩 警 教 儉 寬 快 命 盤 優 醫 重 征 書 刑 子 
它=們 就 還 的 是 在 有 所 能 會 也 對 將 為 又 以 從 用 
面=前 子 孔 包 貌 對 目 容 龐 色 向 頰 談 具 粉 積 部 熟 盆 紗 臨 條 生 皮 罩 食 善 湯 筋 糊 世 皂 謝 值 額 洽 議 紙 上 有 試 料 膜 相 人 板 見 海 霜 對 無 露 紅 觀 授 交 瓜 案 嫩 兒 壁 餅 稟 呈 陳 茶 點 袋 坊 肥 館 巾 寬 門  商 首 市 塑 團 癱 晤 紋 敘 型 諭 顏 磚 層 朝 的 價 
結=果 婚 束 構 合 論 實 局 成 尾 交 識 晶 子 巴 伴 社 冰 核 親 算 語 存 締 帖 緣 扎 案 盟 石 業 余 集 出 了 下 為 賬 怨 匯 黨 繩 腸 穗 轉 隊 網 發 拜 疤 幫 仇 彩 伙 關 垢 節 痂 塊 膜 清 舌 義 癥 點 凍 對 鄰 鈴 式 霜 冤 
政=府 治 策 權 客 體 黨 界 局 變 委 協 論 事 務 敵 見 令 法 工 績 要 柄 壇 綱 情 區 制 經 教 改 風 和 紀 企 審 道 略 
需=要 求 持 在 知 用 有 索 
答=應 道 復 話 案 辯 詞 對 謝 出 卷 允 問 題 錯 曰 疑 禮 拜 茬 數 言 
簡=直 單 練 短 陋 稱 潔 略 樸 便 明 化 要 易 捷 括 寫 約 編 答 史 報 古 章 譜 述 縮 訊 介 體 歷 評 表 拼 況 裝 論 圖 本 板 辦 牘 記 慢 省 釋 則 札 繁 碼 陽 
外=面 國 邊 人 婆 來 頭 交 行 表 界 史 套 孫 衣 文 號 地 省 出 加 甥 貌 族 場 部 形 帶 患 屋 債 語 科 賓 圍 匯 路 觀 埠 公 流 侮 快 事 務 力 向 援 在 道 姓 遇 長 敵 僑 景 勤 鄉 相 罩 掛 逃 方 商 殼 戚 感 貨 派 聯 教 化 調 客 皮 資 財 銷 心 幣 敷 籍 寇 貿 傷 因 差 存 禍 角 圈 線 延 域 的 電 展  間 型 有 傳 活 賣 置 借 泄 訪 市 經 接 層 星 側 設 露 企 運 海 用 購 頻 區 包 校 弦 焰 引 框 艙 服 緣 灘 顯 家 輪 連 耳 腦 辦 邦 編 鈔 廠 城 翻 稃 藩 話 踝 放 稿 功 港 舅 軍 徑 刊 空 篇 遷 氣 欠 親 胎 網 騖 縣 需 項 溢 煙 揚 洋 沿 院 子 痔 招 傳 堡 壁 島 壕 積 碼 門 蒙 膜 切 傾 腎 滲 手 水 宿 野 陰 
媽=呀 咪 的 祖 在 
魯=迅 莽 山 尼 爾 班 菜 鈍 肅 藝 直 北 國 能 
方=面 法 便 才 向 式 言 桌 針 始 子 案 位 步 丈 形 塊 圓 凳 寸 格 略 糖 音 字 顯 巾 藥 劑 框 程 的 可 今 能 正 有 尺 舟 知 根 志 術 型 家 里 材 差 隊 技 將 勝 士 外 陣 磚 城 盒 山 
離=開 婚 家 奇 去 別 散 異 職 休 間 過 此 它 她 心 任 境 子 隊 島 港 場 岸 校 棄 世 譜 地 席 線 鄉 題 他 軌 合 群 愁 京 亂 格 宮 崗 解 叛 情 索 騷 弦 析 轍 層 石 座 
詩=人 歌 文 集 意 句 詞 劇 話 篇 作 選 韻 壇 抄 體 圣 史 章 經 刊 社 學 書 云 風 論 律 碑 才 豪 會 行 品 情 興 仙 余 友 節 
漸=次 變 露 寬 暗 趨 進 成 減 遠 增 近 入 冷 暖 熱 染 悟 顯 化 的 地 強 弱 少 現 小 隱 愈 
汽=車 笛 水 油 船 艇 機 燈 輪 缸 碾 暖 錘 化 酒 包 鍋 門 泡 配 壓 
教=育 授 員 師 訓 書 堂 會 學 養 導 徒 室 務 士 官 皇 義 材 誨 練 課 友 主 案 唆 益 派 條 鞭 法 程 宗 規 本 你 廷 頭 工 區 委 的 你 人 我 具 職 化 他 研 理 改 團 父 過 她 子 給 到 壞 齡 令 參 唱 輔 范 管 母 門 民 名 壇 習 正 出 女 權 運 旨 
男=人 子 女 孩 性 兒 客 生 士 裝 賓 家 方 式 足 工 廁 聲 友 童 的 籃 嬰 單 星 仕 雙 角 隊 排 丁 爵 科 模 權 尸 團 根 妓 仆 色 巫 用 娼 
消=息 失 滅 遣 極 磨 化 沉 耗 逝 除 瘦 毒 費 閑 受 長 融 亡 退 防 火 渴 暑 損 減 散 災 炎 弭 解 夜 腫 去 磁 愁 彌 泯 氣 食 釋 聲 蝕 停 夏 歇 協 音 得 像 
恐=怕 怖 懼 慌 嚇 龍 獸 
變=成 化 為 動 更 換 法 幻 態 革 故 色 相 賣 亂 卦 形 心 質 異 天 通 節 種 性 樣 數 得 的 了 遷 量 身 臉 壞 小 焦 速 大 奏 回 陣 出 作 過 黑 現 調 暖 電 慢 濃 強 軟 濕 甜 咸 做 易 好 黃 白 型 局 頻 淡 紅 壓 星 來 產 蛋 工 價 口 盤 去 聲 體 味 文 位 暗 薄 扁 長 遲 粗 低 短 多 干 格 厚 緊 空 快 寬 藍 老 冷 涼 亮 美 平 淺 青 輕 清 熱 弱 少 松 酸 細 向 新 修 音 硬 圓 臟 造 址 皺 跛 
清=楚 醒 靜 晨 早 潔 晰 明 脆 華 新 涼 水 理 香 高 白 秀 算 泉 風 淡 閑 爽 澈 冷 朗 凈 瘦 茶 除 亮 幽 苦 雅 官 查 音 流 湯 貧 廉 單 還 洗 償 點 樣 江 苑 靈 歌 池 版 掃 規 河 正 醇 剿 盤 代 朝 純 熱 遠 輝 談 末 心 繳 場 麗 甜 宮 廷 蒸 塘 真 唱 酒 潤 倉 史 兵 溪 燉 平 空 欄 冽 碧 飆 冊 澄 道 黨 福 寒 豁 芬 火 稿 供 寂 減 俊 庫 口 客 名 欠 漆 訖 切 秋 ? 奇 尚 通 退 玩 婉 馨 鮮 夜 議 逸 瑩 油 越 運 淤 揚 漪 障 賬 湛 丈 濁 整 和 淺 虛 出 豐 澗 教 零 律 人 鄉 星 徐 野 原 
若=是 干 非 有 要 不 果 能 想 無 與 遇 說 再 用 需 使 夫 蟲 何 羌 失 時 
坐=下 定 牢 視 莊 標 席 墊 待 鎮 像 浴 騎 等 探 具 在 著 擁 車 到 姿 椅 船 滿 地 禪 監 過 蠟 力 蓐 班 ? 化 骨 果 功 困 科 秋 商 失 守 臺 胎 堂 誤 藥 夜 贓 診 支 罪 車 
立=刻 即 場 時 志 法 體 正 論 意 功 誓 國 地 足 案 秋 業 春 冬 柜 方 黨 軸 柱 夏 委 下 約 于 新 定 人 項 德 說 異 起 言 身 命 馬 領 絨 標 等 戶 候 卷 腳 交 井 決 米 式 射 嗣 憲 齋 賬 字 姿 碑 成 木 群 升 像 
快=樂 活 要 板 意 車 速 步 感 信 慰 書 班 慢 當 報 手 譯 迅 吃 逃 嘴 照 餐 攻 件 訊 捷 的 遞 到 來 些 點 了 去 艇 門 得 走 于 進 干 跑 人 馬 刀 打 說 如 看 做 貨 滾 槍 事 像 性 婿 運 語 魚 船 地 適 行 
老=人 爺 實 板 師 婆 是 子 大 虎 鼠 年 者 弟 頭 家 兄 伴 友 伯 九 式 少 翁 話 鄉 練 成 總 小 例 爹 手 牌 鷹 漢 天 將 生 朽 鴉 輩 娘 鴇 道 調 親 農 旦 本 臉 氣 酒 路 辣 粗 鴰 巢 境 表 底 眼 說 君 臣 站 帖 想 繭 區 營 化 湯 街 公 婦 了 的 父 豆 套 土 邁 弱 死 爸 有 遠 兵 鬼 撾 莊 外 母 二 店 去 歌 財 叔 舊 幼 太 早 樹 夫 病 命 三 弦 到 舍 嫗 編 媽 哥 張 鳥 論 齡 衲 狼 媼 林 淚 理 布 蒼 誠 城 廠 聃 雕 墳 花 趕 光 倌 幾 米 面 耄 派 怕 拳 帥 身 僧 叟 山 態 饕 屋 窩 相 ? 矣 丈 賬 牛 劉 李 王 長 兒 高 姐 舅 馬 彭 鋪 仆 圃 四 孫 吾 嚴 妖 
在=家 于 場 意 世 座 先 下 行 心 望 理 位 案 教 即 握 不 否 呢 職 這 此 內 上 學 其 日 他 有 中 那 大 外 兩 前 校 與 人 美 建 線 哪 后 為 華 以 手 床 旁 想 乎 做 京 說 業 去 看 編 用 野 逃 辦 給 讀 聽 變 朝 嗎 崗 途 押 冊 單 譜 數 船 任 誰 
終=于 身 究 年 結 點 久 極 止 歸 了 局 天 因 南 獲 場 審 生 日 端 能 將 老 站 成 須 至 伏 古 篇 霜 歲 朝 板 夜 
美=國 麗 術 好 人 妙 滿 德 觀 貌 女 景 洲 學 感 化 軍 元 金 味 酒 夢 容 名 談 言 意 差 食 玉 事 譽 圖 神 乳 萍 媚 格 帝 服 育 餐 工 的 加 英 分 方 式 白 玲 商 林 籍 善 顏 日 發 語 色 眉 腿 艷 體 得 蘇 稱 展 奴 髯 編 鈔 傳 后 氣 聲 文 協 院 制 專 丑 達 姑 男 幸 雪 援 姿 
曉=得 諭 風 
突=然 出 破 擊 變 圍 起 厥 進 地 襲 入 發 顯 兀 現 飛 審 遇 觸 堤 降 泉 升 增 
研=究 討 磨 制 習 發 讀 判 修 墨 評 碎 
態=度 勢 
丈=夫 人 量 
力=量 氣 求 學 爭 圖 盡 撼 挺 點 士 度 的 推 強 大 保 行 道 克 作 偶 撐 促 戰 勸 主 避 巴 臂 挫 持 畜 場 攻 薦 戒 矩 拼 排 錢 挽 證 陳 擊 系 心 
前=面 進 后 途 天 來 線 者 方 年 頭 門 輩 人 夕 邊 額 程 往 次 站 言 驅 臺 身 提 景 鋒 任 例 世 妻 夫 襟 期 腳 沿 導 塵 列 敵 送 哨 緣 奏 浪 記 傳 廊 腦 科 衛 項 兆 綴 臂 的 已 日 晚 瞻 有 所 三 路 幾 行 述 排 去 文 因 半 些 端 車 段 生 置 輪 叉 夜 部 款 事 嫌 傾 定 清 朝 情 代 場 個 庭 兒 此 艙 仇 房 漢 茅 愆 秦 晌 腿 賢 胸 院 軸 肢 爪 掌 齒 燈 頂 郭 橋 蹄 廳 桅 閘 
吃=飯 驚 虧 力 苦 素 緊 水 光 香 重 慣 菜 定 牌 透 了 的 過 得 完 掉 喝 到 飽 藥 下 勁 著 多 人 肉 點 魚 剩 奶 草 糧 請 上 盡 醋 進 面 糖 法 食 癟 穿 刀 貨 葷 口 青 相 心 準 嘴 齋 罪 茶 頓 好 酒 客 膩 軟 住 
旁=邊 人 觀 聽 門 證 及 的 白 顧 落 路 出 側 騖 支 坐 通 系 枝 注 
電=話 影 燈 車 報 視 光 線 鈴 梯 筒 氣 腦 臺 文 扇 子 力 流 訊 門 爐 機 網 棒 閃 廠 匯 器 學 碼 噴 暖 測 騾 驢 費 令 椅 鰻 鈕 石 波 場 磁 鍍 工 平 站 池 傳 大 動 告 賀 教 療 磨 木 信 壓 閘 鐘 阻 郵 源 路 玩 的 纜 量 業 算 船 熱 函 擊 能 容 價 筆 刷 表 眼 解 極 荷 離 位 鉆 感 據 霸 陳 瓷 刀 導 荒 焊 弧 耗 復 掛 稿 灌 桿 鋸 母 瓶 勢 聲 燙 頭 刑 唁 泳 冶 邀 白 板 度 化 納 橋 滲 樞 魚 暈 針 鑄 
爸=媽 在 
房=子 間 門 屋 東 租 頂 產 客 主 契 檐 價 事 室 帖 車 內 舍 梁 改 里 錢 本 補 顫 艙 柁 費 管 基 架 款 市 山 型 源 照 展 捐 龍 前 縣 
剛=才 巧 好 強 毅 健 果 正 直 性 猛 勁 烈 石 體 出 被 到 過 柔 走 硬 來 要 度 韌 當 好 到 介 毛 學 勇 玉 架 晶 死 
究=竟 辦 其 詰 問 
難=道 過 得 受 堪 以 看 免 民 于 怪 處 為 題 忘 聽 關 辦 事 找 產 吃 當 聞 色 友 捱 抑 脫 容 卻 能 留 離 啃 管 搞 斷 除 酬 出 度 點 的 逃 有 解 做 求 講 保 行 料 了 分 忍 言 逢 耐 買 尋 辨 舍 眠 測 懂 防 倒 學 兄 易 說 纏 如 消 打 熬 人 胞 活 僑 上 住 癥 申 惹 被 弟 讀 記 局 覓 平 熔 寫 續 遇 治 字 
假=若 如 使 裝 山 定 話 期 充 借 設 冒 名 意 日 想 扮 手 象 貨 發 牙 煙 酒 說 藥 座 條 案 言 的 釋 肢 人 作 面 劣 幣 報 唱 鈔 打 寐 球 死 托 性 造 賬 傳 緞 根 果 哭 領 皮 聲 睡 腿 惜 戲 笑 植 足 髻 
英=國 雄 文 語 勇 俊 明 里 武 豪 才 名 靈 甲 姿 杰 魂 鎊 寸 烈 皇 倫 美 漢 華 法 式 中 譯 軍 尺 偉 籍 模 年 方 畝 制 磅 兩 超 噸 氣 石 挺 尋 山 士 特 
經=過 驗 濟 常 歷 理 營 費 典 手 受 書 商 文 籍 紀 學 心 傳 管 久 售 辦 略 查 綸 絡 貿 銷 血 由 此 緯 年 部 卷 期 委 師 世 痛 脈 閉 度 紗 事 線 意 援 行 合 密 洗 軸 
偉=大 人 業 力 績 哥 論 岸 
名=字 詞 人 譽 義 片 稱 目 士 聲 著 勝 家 單 流 言 分 山 氣 貴 望 堂 號 下 利 作 句 冊 牌 手 城 將 位 產 節 花 額 師 列 菜 曲 醫 次 物 嘴 之 相 企 妓 喚 捕 酒 為 叫 學 校 錄 教 模 女 店 兒 車 畫 曰 廠 優 媛 伶 駒 銜 就 茶 廚 匠 實 門 揚 數 理 儒 刺 臣 旦 諱 角 跡 劇 款 品 篇 票 氏 宿 剎 帖 特 姓 煙 章 詩 
往=后 來 事 常 年 返 昔 復 時 屆 上 下 日 前 外 北 西 南 還 右 回 天 會 里 
讀=者 書 物 本 音 報 研 誦 卡 好 數 友 取 經 的 到 過 了 完 出 寫 后 法 成 作 入 霸 看 秒 破 盤 一 史 錯 懂 
無=論 法 聊 數 從 限 不 須 意 非 聲 用 關 力 情 知 疑 窮 形 恥 處 名 益 端 心 奈 能 比 望 味 盡 怪 異 賴 效 理 辜 禮 錫 暇 為 故 罪 權 私 愧 色 視 由 機 日 誤 期 線 償 翼 它 腦 解 跡 地 界 煙 軌 可 人 所 任 敵 助 依 謂 一 懼 緣 礙 邊 遺 病 悔 常 損 上 缺 事 憂 風 明 此 量 言 雨 間 計 我 涯 功 題 錢 出 害 妨 以 業 蹤 幾 甚 怨 時 恙 神 價 他 畏 錯 證 水 方 性 路 影 主 阻 余 毒 規 著 作 過 物 多 行 傷 話 果 憾 極 瑕 后 對 語 利 痛 頭 疆 雙 光 成 縫 義 前 序 趣 底 往 閥 及 目 匹 存 奇 如 邪 際 聞 虞 息 梁 稽 歸 垠 慮 菌 干 痕 炸 碼 塵 乃 補 措 猜 度 定 華 核  何 告 援 則 那 別 諱 級 忌 角 眠 妻 手 霜 土 袖 雪 眼 已 藝 皂 棣 羈 
任=何 務 憑 性 意 教 命 職 用 情 免 期 你 由 一 內 其 君 人 選 便 從 課 滿 泉 所 丘 隨 俠 
比=較 如 方 喻 賽 例 作 擬 武 劃 鄰 照 率 重 增 干 才 試 價 分 量 熱 我 起 一 你 人 上 他 對 丘 在 數 下 美 爾 高 為 特 拼 年 了 多 做 肩 來 附 及 況 配 歲 索 一 翼 值 著 諸 反 容 薩 紹 濕 手 之 
門=口 前 房 檻 簾 洞 戶 面 框 路 窗 牌 樓 牙 縫 板 第 環 生 首 徒 楣 徑 票 庭 道 對 神 類 衛 市 臉 風 聯 里 診 警 崗 將 外 鎖 內 派 下 人 上 后 邊 廊 鈴 兒 球 扇 額 巴 匾 鈸 鼻 齒 丁 釘 斗 墩 閥 扉 幅 館 禁 鏡 客  閂 廳 限 子 把 弟 店 號 階 柱 
預=備 先 言 定 料 科 感 期 想 算 防 告 約 兆 測 報 祝 示 計 見 謀 展 交 演 留 制 訂 購 習 設 警 估 售 覽 知 繳 賽 付 支 熱 考 審 風 選 案 卜 斷 分 后 收 行 裝 征 把 表 產 借 覺 冷 燒 述 壓 置 作 
接=著 受 觸 近 到 連 口 洽 待 收 見 濟 風 頭 生 應 通 壤 手 替 送 辦 納 任 班 線 地 力 氣 合 種 茬 管 獲 駁 下 聽 拍 軌 入 過 上 報 續 機 掌 了 吻 住 客 點 球 好 引 龍 活 踵 縫 來 進 人 鄰 產 火 訪 防 骨 羔 柜 駕 界 警 境 交 取 腔 親 墑 事 穗 榫 談 物 援 診 站 嘴 招 木 神 芽 枝 
頭=發 腦 兒 痛 頂 皮 人 疼 等 銜 顱 昏 緒 部 里 子 巾 目 號 尾 繩 骨 生 像 錢 式 角 功 馬 羊 油 版 盔 飾 陀 套 條 上 面 暈 先 獎 大 燈 中 寸 路 蓋 年 領 臉 籌 茬 道 伏 花 頸 家 髻 名 牌 球 前 晌 紗 虱 天 兒 胎 晚 癬 雁 標 彩 篩 屑 
語=言 氣 文 聲 調 法 錄 音 匯 句 意 病 系 群 出 態 的 義 種 境 聊 料 感 庫 塞 素 速 絲 體 委 序 用 族 風 根 源 
痛=苦 快 哭 恨 心 罵 楚 惜 切 打 飲 癢 悼 斥 悔 感 擊 處 徹 扁 不 責 覺 的 失 得 風 惡 陳 經 殲 懲 死 
打=算 開 聽 牌 扮 仗 倒 破 架 擊 發 斷 量 下 動 碎 掃 岔 敗 擾 趣 點 通 鼓 攪 手 鐵 雜 賭 獵 滾 消 入 針 轉 球 槍 法 亂 字 響 靶 頭 垮 撈 工 火 氣 探 眼 炮 勾 單 沉 全 造 夯 斗 藥 樁 包 場 瓜 印 了 道 假 出 得 壓 到 個 死 好 劫 理 的 過 完 傷 成 在 著 進 中 贏 上 起 我 從 人 罵 錯 他 磨 來 和 網 折 底 掉 圍 翻 坐 落 爛 水 對 稿 圈 橫 結 散 分 給 拼 孔 定 盹 魚 緊 住 鬧 雷 愣 零 蠟 擂 蔫 呃 表 苞 比 叉 ? 車 春 柴 草 抖 疊 頂 滑 壞 鼾 ? 非 黑 諢 昏 晃 更 鉤 卦 拐 鬼 嗝 光 醮 價 尖 井 酒 壙 卡 滿 門 鳴 扒 泡 譜 平 千 釬 拳 搶 閃 扇 私 傘 殺 胎 退 挺 問 旋 烊 樣 油 援 戰 顫 皺 嘴 早 麥 遍 穿 椿 破 趣 洞 谷 慣 哈 呼 空 鈴 撲 勝 濕 歪 彎 漁 者 制 鐘 杈 禪 
主=意 人 張 義 要 任 席 角 編 題 持 婦 觀 顧 子 動 峰 辦 體 宰 權 管 筆 旨 將 力 流 見 教 干 謀 演 使 治 考 講 攻 導 帥 從 課 推 鍵 罰 裁 站 格 腦 音 犯 食 文 次 存 官 句 線 頁 日 機 板 因 隊 場 修 唱 理 和 打 菜 事 軸 政 業 客 控 牌 審 營 星 祭 外 仆 閥 調 科 伐 帖 兒 樓 糧 料 幣 創 廚 刀 婚 父 根 公 家 頻 橋 送 訴 上 位 刑 項 語 戰 抓 枝 掌 賓 產 潮 帆 叫 莖 庫 脈 桅 謂 值 
談=話 論 笑 天 心 判 吐 鋒 心 婚 興 到 及 起 了 情 過 得 資 妥 著 柄 清 說 一 助 成 攏 
批=評 判 準 語 示 駁 斗 發 改 注 文 價 閱 貨 量 次 租 件 售 零 捕 辦 點 復 號 活 購 假 條 銷 轉 
再=說 見 不 三 版 度 者 生 現 行 次 婚 掀 如 聚 臨 有 用 作 來 將 造 以 也 在 去 創 做 看 多 與 為 上 找 轉 起 經 過 沒 提 講 差 添 戰 試 犯 想 進 發 回 選 開 分 讓 續 會 高 入 聽 大 好 讀 遭 叫 審 取 世 建 當 嫁 醮 議 則 植 寄 借 近 冷 平 燃 熱 壓 贏 
家=庭 伙 鄉 人 具 族 門 長 務 事 常 屬 眷 產 信 當 小 境 譜 園 教 母 世 父 畜 業 財 書 塾 訓 累 丁 法 宅 風 奴 禽 宴 規 訪 丑 什 底 鴿 雞 史 賊 祠 電 兔 燕 居 中 的 在 有 樂 里 政 用 是 和 住 成 計 傳 姐 聲 系 學 私 資 貧 子 室 道 貓 制 蠶 慈 仇 戶 景 祭 口 雀 鼠 什 童 兄 養 嚴 蠅 鴨 裝 種 祖 珍 山 臣 給 釀 仆 犬 蚊 
半=天 年 夜 晌 截 路 邊 日 舊 圓 數 大 道 價 票 遮 桶 坡 程 成 帶 壁 徑 球 子 島 山 個 點 月 場 生 句 世 時 空 開 部 步 斤 途 身 分 死 百 條 載 裸 熟 托 拉 飽 酣 角 休 夏 音 腰 影 白 打 蹲 幅 會 級 節 刻 塊 里 瓶 旗 圈 宿 仙 箱 頁 張 
重=要 慶 新 大 視 復 量 疊 擔 建 點 印 傷 陽 溫 心 任 演 用 圍 負 返 托 鎮 孝 言 婚 價 利 申 地 金 炮 洋 版 活 孫 力 于 擊 歸 覆 典 音 振 辦 兵 合 檐 型 的 組 整 案 現 生 開 回 創 獲 出 修 提 頭 聚 寫 發 逢 蹈 考 置 塑 影 裝 來 燃 犯 選 審 唱 游 約 責 做 述 奏 光 氫 碼 作 啟 名 罪 播 茬 讀 放 行 鋼 九 判 試 沓 望 文 午 霄 樣 譯 圓 張 禮 病 磅 臂 寶 彩 挫 臣 懲 彈 罰 荷 話 獎 劍 疾 情 裘 賞 水 物 刑 謝 壓 油 載 資 在 殘 抄 打 地 度 訪 工 教 扣 錄 落 描 映 地 
倒=是 下 霉 退 閉 塌 掛 影 戈 流 懸 貼 轉 車 數 插 腳 還 臺 換 立 裝 彩 刺 伏 賣 置 手 騰 爺 在 地 入 的 了 也 臥 班 買 進 有 斃 頭 要 出 扣 掉 把 垂 倉 茬 茶 帶 好 匯 放 風 灌 閣 剪 嚼 睫 賠 票 嗓 鎖 替 坍 休 敘 序 映 運 牙 煙 仰 賬 灶 找 背 計 角 空 滿 豎 水 推 寫 
參=加 看 觀 考 謀 與 政 軍 見 事 拜 照 贊 戰 訓 保 上 閱 賽 半 選 展 差 數 院 股 量 演 訪 議 悟 天 詳 透 茸 禪 訂 劾 合 會 建 校 拍 評 審 試 校 謁 驗 酌 雜 證 將 
年=輕 紀 青 代 齡 頭 歲 老 間 底 假 糕 會 畫 光 華 鑒 初 級 貨 事 譜 號 成 份 下 限 終 輩 表 飯 金 刊 菜 度 景 歷 審 久 有 輪 利 息 報 薪 資 前 內 后 來 期 中 時 半 費 滿 約 幼 僅 月 數 增 經 尾 均 高 少 屆 產 里 檢 冬 宵 逾 末 率 邁 租 關 近 節 根 禮 齒 俸 庚 饉 貌 首 壽 兄 夜 長 尊 制 
輕=聲 易 松 視 快 微 巧 重 薄 盈 柔 佻 率 便 浮 傷 捷 信 風 飄 舟 狂 饒 俏 彈 騎 生 閑 裝 的 型 度 取 工 撫 按 言 功 則 拍 忽 身 觸 打 擊 劍 擂 推 者 敵 蔑 慢 煙 紗 靈 軟 暖 財 紡 活 放 緩 軌 賤 健 看 省 水 侮 揚 質 罪 塵 兵 擦 吹 待 點 拂 妙 敲 悄 的 地 石 咬 音 油 撞 叩 
才=能 是 子 力 華 干 氣 學 智 女 情 略 分 思 識 望 貌 會 有 算 對 好 行 在 說 開 把 去 到 來 使 肯 剛 藝 用 看 要 敢 給 叫 俊 怪 具 買 下 沒 跟 又 夠 人 更 講 
點=頭 兒 心 頭 綴 子 燃 名 滴 火 破 明 染 數 將 正 眼 開 檔 按 撥 播 卯 射 解 算 收 水 半 了 擊 票 上 就 鐘 出 到 來 起 字 錢 評 菜 過 陣 歌 睛 燈 醒 題 距 化 亮 穴 通 補 兵 穿 竄 對 火 焊 饑 球 清 位 戲 驗 種 定 畫 檢 煙 閱 著 
運=動 用 氣 輸 河 行 送 轉 往 費 作 算 糧 管 載 籌 銷 營 程 到 抵 貨 來 城 回 走 價 出 力 量 道 球 煤 筆 單 腳 數 思 搬 兵 鈔 星 
熱=鬧 情 烈 心 愛 氣 誠 血 水 淚 度 天 茶 忱 力 帶 風 河 望 切 湯 衷 戀 病 和 腸 潮 量 乎 火 門 辣 鍋 菜 評 浪 流 點 癥 線 學 源 賣 的 身 能 銷 敏 軋 絡 得 土 障 值 狗 了 飲 電 食 鍵 播 幣 補 炒 地 鐓 敷 合 化 貨 核 管 購 機 勁 解 孝 壓 戰 字 性 泵 表 炕 狂 燙 舞 液 阻 
客=人 氣 廳 觀 棧 店 套 房 船 串 車 艙 體 站 位 家 飯 官 票 商 姓 戶 機 籍 星 運 貨 源 席 服 輪 座 流 滿 舍 場 隊 居 卿 死 歲 室 
民=族 眾 間 主 權 兵 歌 心 意 政 賊 生 警 工 力 俗 事 情 用 風 船 謠 團 治 聲 婦 諺 辦 憤 航 怨 法 樂 命 委 建 進 運 調 居 國 選 營 企 望 宅 和 品 校 房 田 有 初 智 粹 強 女 變 防 夫 革 家 盟 瘼 氣 庭 約 憂 豐 社 債 
隨=便 著 時 手 即 后 意 口 筆 同 地 身 處 和 從 軍 員 行 車 機 帶 群 之 緣 風 想 俗 心 隊 侍 喜 到 感 常 調 訪 記 遷 順 葬 其 州 
院=子 落  務 刊 級 士 校 方 所 內 線 系 外 里 門 部 畫 長 中 
了=解 事 結 卻 局 罷 之 你 不 嗎 當 些 無 得 耶 斷 然 手 賬 
抗=戰 議 日 拒 爭 辯 旱 衡 擊 逆 非 法 暴 洪 御 大 癌 體 病 菌 敵 命 原 澇 聯 凝 寒 婚 稅 訴 倭 性 災 震 毒 風 告 捐 議 力 熱 生 酸 壓 
反=對 正 而 抗 映 倒 復 動 之 應 感 駁 攻 問 省 面 是 常 帝 響 射 叛 悔 擊 手 撲 光 黨 思 話 比 襯 向 壓 題 導 差 饋 派 彈 觀 貪 恐 轉 的 目 華 了 鎖 美 串 口 腐 碼 序 共 方 胃 諷 戰 證 白 照 清 哺 霸 綁 芻 側 超 沖 調 戈 顧 詰 季 間 剪 扒 聘 潛 切 訴 身 噬 水 誣 語 咬 右 坐 到 讀 告 角 接 例 力 論 色 跳 相 修 演 義 英 責 
找=到 尋 事 回 錢 頭 看 抽 一 了 罵 茬 出 來 了 個 你 人 些 過 遍 零 補 病 還 平 齊 死 贖 轍 碴 樂 誰 準 著 
婦=女 人 聯 孺 道 科 德 嬰 幼 
敵=人 機 軍 手 意 對 視 國 我 后 偽 方 寇 情 陣 畏 艦 區 群 樓 害 境 愾 酋 臺 探 特 焰 友 兵 穴 營 
好=處 幾 看 不 多 些 人 在 久 聽 事 意 笑 似 玩 話 比 奇 友 吃 壞 歹 心 漢 受 過 感 說 走 兒 戲 使 運 生 手 轉 色 找 學 客 惡 勝 評 戰 賴 銷 文 詩 軟 巧 覺 貨 喝 官 飯 菜 傻 猛 疼 糙 棋 強 耍 的 了 讓 嗎 想 書 有 難 快 啦 大 用 呀 呢 少 吧 動 時 慘 講 丑 景 啊 高 到 黑 像 痛 歌 累 遠 辦 貴 當 長 夢 做 賣 要 天 問 老 美 報 不 惹 哇 亂 會 點 香 個 氣 上 小 球 怪 近 酒 慢 死 深 極 記 花 寫 命 字 名 急 帖 圖 ? 臉 兒 斗 懂 干 過 爽 尚 聞 險 言 暗 白 棒 辯 毒 賭 短 鋼 紅 滑 畫 黃 劍 緊 苦 酷 困 辣 懶 爛 冷 涼 亮 綠 澀 瘦 熟 燙 甜 頭 為 鮮 兇 樣 圓 賺 壯 
報=告 紙 仇 復 館 刊 酬 道 章 答 社 應 名 信 到 國 考 恩 銷 效 界 廢 童 案 償 表 喜 捷 攤 建 送 曉 請 單 警 價 時 頭 關 讀 稱 業 上 稅 失 料 人 載 以 收 出 批 盤 販 分 驗 文 德 樣 領 欄 廊 靶 呈 春 端 花 話 功 官 獎 架 礦 幕 數 審 喪 亭 務 修 冤 眼 憂 賬 站 子 錯 夾 箱 
走=過 開 路 向 廊 狗 動 遍 道 私 失 邊 火 樣 卒 讀 訪 掉 氣 穩 不 調 俏 禽 勢 到 了 出 進 的 在 上 去 入 近 得 低 高 強 來 光 回 下 吧 著 紅 后 避 人 錯 完 時 獸 好 遠 呀 馬 合 漏 臺 棋 露 軟 啊 板 筆 鏢 步 電 風 口 水 神 散 扇 墑 繩 索 脫 題 味 穴 形 險 運 眼 一 嘴 賬 看 
很=多 快 窄 雜 瘦 軟 胖 亮 費 淡 白 暗 火 牛 霉 大 難 好 少 有 高 久 想 強 長 不 遠 低 愛 小 深 差 短 美 像 受 易 早 累 忙 痛 廣 怕 慢 能 近 熱 會 棒 冷 熟 輕 嚴 晚 對 煩 緊 苦 壞 慘 細 傻 怪 新 酷 弱 遲 丑 濃 淺 厚 沒 懂 老 亂 兇 爽 全 菜 懶 熟 數 重 薄 飽 粗 黑 紅 急 舊 寬 香 行 硬 糟 直 
差=別 異 錯 遣 役 距 勁 的 點 額 價 了 派 得 誤 人 旅 池 等 果 可 事 使 數 生 失 動 遷 值 
幫=助 忙 忙 手 兇 子 腔 工 會 辦 它 派 他 襯 她 人 補 您 了 主 上 定 場 廚 湊 帶 扶 教 困 套 貼 閑 傭 
哥=達 兒 們 倆 
另=外 行 眼 辟 選 一 有 類 加 設 存 據 覓 議 立 謀 找 擔 告 定 案 冊 
準=備 確 保 許 兒 則 時 予 是 行 繩 頭 尉 將 譜 星 的 入 點 定 話 信 線 不 假 據 能 
是=的 否 非 啥 一 由 在 我 次 要 有 以 為 個 指 不 對 他 從 這 你 人 說 香 無 可 中 大 把 真 自 會 該 被 受 按 好 想 小 美 故 做 錯 嗎 假 也 女 男 近 死 處 啊 活 白 呀 吧 不 些 凡 岸 到 誰 
昨=天 晚 日 晨 夜 兒 
直=到 接 說 至 覺 奔 線 爽 立 率 言 流 射 通 譯 截 視 系 達 徑 話 角 感 路 叫 掛 翻 闖 屬 播 腸 觀 拍 裰 選 指 銷 航 擊 的 升 飛 逼 撥 上 落 斥 沖 行 發 人 呼 搗 抵 轄 隸 白 尺 陳 待 道 根 諫 快 面 書 抒 性 腰 音 傳 讀 經 鏈 營 喻 
的=確 士 人 哥 
街=上 道 頭 門 市 坊 燈 面 巷 邊 角 景 口 車 壘 區 霸 機 貌 舞 心 名 
天=下 氣 空 上 津 地 真 才 生 井 色 然 堂 性 亮 橋 子 使 國 涯 賦 王 文 際 意 光 命 神 師 宮 皇 理 河 職 平 時 公 日 道 鵝 花 幕 書 窗 仙 竺 狗 籟 體 山 災 機 分 棚 象 干 壤 線 宇 主 資 府 險 青 庭 幸 年 條 極 煞 熱 冷 趣 梯 球 兵 候 驕 塹 火 稟 敵 電 罡 穹 的 內 水 臺 后 父 會 一 賜 壇 黑 大 馬 人 倫 明 心 陰 邊 降 網 數 晴 龍 啊 和 蝎 外 寶 成 說 價 佑 車 呀 工 安 眼 保 高 界 池 蛾 啟 元 藍 正 門 女 長 帝 威 祥 方 良 牛 波 妒 頂 旱 溝 癸 麻 闕 授 順 頭 浴 閹 淵 葬 軸 足 尊 姿 擇 質 變 蠶 朝 燈 底 碟 冬 寒 湖 哪 譴 清 全 問 演 柱 祝 宗 
等=到 于 候 待 級 同 次 差 職 號 第 分 價 溫 地 人 著 了 你 高 來 個 外 得 物 值 下 上 獎 車 額 閑 身 效 量 角 邊 不 她 他 我 份 距 式 一 腰 速 重 
低=聲 頭 下 級 垂 微 沉 估 于 音 廉 洼 劣 調 潮 緩 空 壓 云 平 燒 的 層 價 迷 落 位 點 息 胸 溫 谷 檔 能 著 地 薪 俗 等 頻 速 飛 階 分 處 矮 到 糖 度 熱 齡 利 凹 保 倍 產 唱 端 耗 徊 回 格 賤 就 眉 聘 限 吟 語 啞 沈 映 毒 領 柔 濕 首 效 
努=力 嘴 責 
代=表 替 價 理 筆 序 辦 數 溝 勞 詞 金 發 養 號 管 銷 謝 換 碼 為 以 之 行 工 步 入 課 收 言 培 用 購 開 售 幣 償 稱 花 還 耕 扣 庖 書 位 職 租 征 考 打 件 寫 
尤=其 為 物 佳 以 甚 須 文 異 勇 妙 里 
理=想 由 論 解 會 智 性 事 應 當 睬 發 科 學 財 化 路 家 合 念 療 順 據 工 你 過 出 算 貨 氣 賠 虧 查 清 光 短 該 屈 喻 法 
見=到 面 解 識 聞 怪 好 證 地 長 效 報 面 教 習 狀 過 了 底 于 其 諒 得 工 諸 山 慣 天 頂 智 光 血 客 多 鬼 笑 機 外 老 禮 背 方 輕 新 責 長 罪 紅 下 
來=到 說 往 信 得 自 回 著 源 臨 人 講 訪 賓 歷 客 意 生 路 由 頭 日 世 稿 年 書 函 文 勁 勢 犯 后 碗 杯 句 襲 件 的 港 看 了 電 這 做 對 時 吧 找 臺 學 過 之 華 接 去 向 聽 吃 此 使 處 者 用 歸 安 想 歲 啦 呀 啊 料 神 事 點 鴻 抓 京 潮 火 氣 雖 晚 項 不 鳳 福 復 攻 呢 蘇 
曾=經 孫 祖 見 在 于 有 與 被 說 為 任 向 對 是 到 獲 因 以 將 用 聽 想 把 去 隨 
繼=續 承 而 母 之 父 任 配 嗣 后 位 女 室 武 業 子 海 進 起 由 
影=響 子 片 印 射 壁 戲 像 院 星 霸 視 評 集 迷 壇 展 音 碟 帝 城 業 樓 人 劇 后 調 跡 訊 蹤 都 
戰=爭 士 斗 場 事 勝 時 線 略 術 后 前 友 敗 死 抖 壕 區 役 亂 火 績 馬 艦 法 歌 局 鼓 俘 功 報 勤 車 云 備 犯 平 成 帖 警 記 史 船 禍 將 具 果 機 況 炮 書 國 栗 地 神 隊 陣 袍 例 表 端 刀 幕 旗 鷹 罷 斧 情 悚 
責=任 備 罵 罰 難 問 怪 成 令 打 編 分 
路=上 邊 線 過 子 費 程 口 途 徑 燈 數 面 警 局 標 基 礦 遙 牌 軌 段 條 向 政 旁 人 德 由 加 經 滑 障 易 北 道 南 霸 碑 堤 風 徽 規 祭 劫 況 考 卡 電 簽 塹 演 遇 
妹=子 夫 婿 兒 丈 
種=子 族 類 地 花 田 植 瓜 仁 下 樹 過 上 菜 草 群 牛 別 差 畜 痘 蛋 苗 馬 禽 條 養 源 豬 肥 糧 麻 皮 質 
創=作 造 刊 辦 立 傷 痕 建 始 設 業 制 新 口 舉 化 見 匯 收 意 下 出 世 面 利 編 獲 稅 痛 優 議 術 
承=認 受 擔 繼 辦 德 襲 當 重 接 諾 攬 運 載 包 建 托 保 租 蒙 造 銷 上 印 讓 恩 付 旭 儲 傳 塵 兌 歡 乏 購 命 平 情 題 望 想 修 應 做 轉 制 貸 佃 教 
散=文 步 開 布 發 漫 會 場 落 記 步 失 播 心 心 兵 居 射 客 華 曲 光 架 戶 去 熱 亂 了 裝 工 件 打 手 板 伙 放 寒 劑 結 水 攤 套 體 戲 學 席 頁 養 佚 座 置 財 出 彈 股 焦 盡 悶 沙 碎 在 
幸=福 而 虧 運 好 免 喜 事 無 存 得 臣 會 進 甚 生 
介=紹 意 于 入 詞 乎 懷 質 面 子 音 蟲 休 
甚=至 而 少 為 高 或 大 遠 佳 廣 微 是 受 好 于 妙 
穿=著 插 戴 梭 行 越 孔 刺 上 過 了 的 衣 透 好  心 破 廊 幫 堂 線 孝 鞋 窬 云 鑿 針 洞 壞 舊 來 入 靴 
奇=怪 跡 異 特 妙 觀 事 聞 才 遇 麗 景 談 功 峰 巧 襲 癢 香 險 俠 松 山 低 兵 志 緣 幻 趣 人 案 想 石 葩 絕 高 謀 數 慢 瑞 偶 詭 崛 計 譎 缺 偉 文 效 勛 秀 點 境 快 術 臺 譚 冤 
形=式 容 象 成 勢 狀 態 體 跡 似 相 骸 制 神 變 聲 的 像 同 貌 色 如 碼 旁 勝 影 音 質 
忘=記 卻 掉 懷 我 情 本 光 性 了 形 年 私 返 憂 帶 恩 
和=平 尚 氣 諧 藹 善 睦 風 好 緩 暖 服 悅 解 親 煦 會 樂 聲 約 易 議 數 順 暢 血 它 金 談 局 弦 我 他 合 記 美 信 你 人 她 音 田 詩 著 靜 龍 衣 誰 春 棋 泥 弄 互 面 盤 洽 紳 祥 碩 熙 縣 
黑=暗 影 色 夜 人 白 板 臉 子 發 狗 幕 洞 土 頭 亮 瘦 地 市 線 種 豆 道 紅 心 手 棗 斑 面 幫 話 體 口 路 暈 絲 泥 腳 熊 貨 馬 炭 店 錢 山 陶 客 點 的 煙 衣 了 龍 箱 豹 霉 盒 字 石 貓 金 云 海 漆 大 興 惡 牢 車 茶 吃 潮 貂 戶 樺 鯇 孩 鍋 鸛 管 價 麥 牌 槍 哨 紗 鼠 帖 糖 天 窩 信 魚 雨 痣 賬 災 竹 狀 格 鬼 河 晶 鯨 磷 奴 屏 棋 鉛 蛇 書 水 松 檀 桃 鷹 油 玉 莓 
果=然 子 實 真 園 樹 皮 斷 木 品 敢 醬 決 兒 餌 汁 干 酒 脯 糖 仁 報 香 枝 穗 味 洛 酸 凍 農 肉 料 綠 茶 菜 腹 膠 殼 盤 蠅 毅 柄 地 核 類 心 
根=本 據 源 基 底 子 苗 由 芽 治 除 絕 毛 區 性 部 兒 瘤 植 雕 號 腳 莖 究 式 系 須 冠 尖 樣 狀 
仍=然 舊 顯 嫌 未 有 是 在 會 可 能 要 需 須 以 將 被 不 為 屬 較 很 應 無 由 對 用 
聰=明 敏 慧 穎 悟 
描=寫 繪 畫 述 摹 圖 紅 金 記 眉 敘 出 
底=下 子 細 稿 層 本 蘊 版 邊 氣 部 樓 兒 盤 片 座 板 工 火 牌 數 線 限 價 色 薪 面 褲 圖 里 營 冊 端 貨 肥 襟 角 架 碼 漆 墑 樣 賬 襯 墊 糞 腳 卷 紋 
懂=得 事 行 了 你 不 
放=心 下 棄 出 開 過 大 手 松 火 假 學 射 任 膽 寬 縱 蕩 映 炮 哨 眼 置 晴 債 工 行 生 言 鹽 誕 電 毒 牧 風 在 入 的 緩 送 進 到 了 慢 上 回 款 低 給 逐 著 光 肆 好 歌 聲 權 水 走 飛 屁 話 個 療 浪 熱 量 流 牛 亮 步 鞭 不 黜 貸 達 刁 定 對 懷 還 荒 花 空 盤 情 槍 散 血 像 一 養 羊 樣 賬 賑 恣 長 錯 倒 掉 活 箭 氣 音 
彼=此 得 岸 端 時 
罷=了 工 休 課 手 市 免 官 論 了 練 兵 筆 黜 考 賽 訟 訴 網 演 職 戰 斥 宴 
鼻=子 孔 涕 尖 煙 梁 音 祖 屎 腔 翼 水 衄 兒 竇 疽 塞 飼 酸 息 血 炎 癌 根 鏡 科 毛 
早=已 晨 上 飯 晚 點 年 期 餐 日 婚 春 熟 茶 市 車 退 班 操 稻 孕 生 被 產 報 間 衰 霜 泄 兒 前 在 的 于 就 有 會 些 知 到 安 起 逝 先 秋 死 去 該 睡 戀 場 潮 讀 慧 育 造 朝 課 
既=然 是 給 當 定 有 可 要 能 不 已 無 而 非 得 往 望 
顏=色 料 面 容 體 
夫=人 婦 妻 子 權 婿 君 家 役 
算=是 作 盤 命 計 數 術 學 法 清 準 上 啥 來 話 草 式 了 出 得 你 起 賬 不 對 了 尺 定 卦 題 子 錯 進 入 
近=來 代 年 處 視 似 日 況 人 鄰 親 便 路 畿 觀 因 海 景 期 的 百 月 乎 照 了 于 身 作 郊 世 東 前 程 道 古 距 旁 情 聞 影 憂 緣 洋 戰 剖 
解=釋 決 放 除 剖 開 散 脫 答 說 悶 圍 嘲 救 體 勸 渴 析 恨 約 數 毒 雇 聘 凍 法 衣 鈴 霸 包 饞 憂 禁 囊 難 讀 壓 困 題 封 密 碼 氣 惑 下 夢 職 熱 藥 譯 出 調 謎 餓 擾 任 纜 飽 愁 差 乏 詁 酒 教 手 送 套 悟 吸 消 疑 嚴 元 郁 組 甲 鎖 頤 
寫=作 信 字 實 法 照 生 本 意 真 入 的 上 了 下 成 出 給 得 在 著 一 道 過 明 到 好 有 完 詩 書 稿 錯 來 就 進 些 景 起 手 頭 
活=動 潑 人 兒 躍 該 力 計 路 氣 現 佛 命 物 字 水 捉 寶 絡 便 頁 結 門 期 口 扣 罪 中 得 著 用 到 塞 性 像 化 埋 過 體 血 祭 靶 茬 法 泛 話 分 賣 錢 棋 食 似 脫 豬 質 檢 栓 魚 
空=氣 中 虛 間 地 前 洞 襲 白 想 話 曠 隙 房 手 閑 闊 兒 頭 軍 談 位 心 泛 論 子 幻 車 調 格 缺 炮 疏 喊 廓 屋 號 對 城 賊 戰 腹 門 竹 當 降 文 穴 額 乏 防 暇 轉 置 運 的 難 無 姐 有 檔 郵 對 余 殼 出 了 倉 耗 慮 泡 域 港 著 言 靈 落 欄 癟 乘 場 處 擋 蕩 行 翻 懷 費 崗 寂 警 際 集 口 茫 名 蒙 漠 勤 駛 身 嫂 投 援 載 鐘 巢 床 山 見 等 谷 開 碼 忙 盼 跑 瓶 腔 速 箱 
勝=利 過 仗 負 任 敗 地 似 跡 景 訴 創 算 出 于 者 率 垞 朝 局 境 機 績 券 
厲=害 聲 鬼 行 色 
困=難 苦 倦 惑 乏 頓 境 擾 守 死 了 人 憊 厄 局 在 的 于 住 窘 獸 覺 居 窮 累 
歡=喜 迎 樂 呼 笑 心 欣 暢 送 騰 快 娛 聚 宴 慶 聲 度 叫 悅 愉 愛 鬧 跳 顏 唱 忭 蹦 好 咍 歌 洽 勢 實 躍 情 息 
道=理 德 路 士 歉 謝 喜 學 家 教 義 人 具 白 場 賀 統 袍 子 法 經 破 口 觀 院 情 縣 里 題 兒 班 出 是 指 上 來 別 明 行 地 光 門 術 岔 床 釘 會 乏 號 姑 牙 砟 長 旁 員 
言=語 論 行 談 辭 和 責 路 教 之 人 中 及 者 說 喻 表 明 情 傳 道 歡 聲 笑 重 狀 
斗=爭 篷 室 智 士 志 膽 笠 毆 圖 車 眼 法 牛 氣 大 筆 方 富 拱 雞 架 箕 牌 趣 渠 筲 艷 妍 嘴 子 敗 技 勇 魚 
耳=朵 邊 目 語 環 根 光 機 聞 熟 膜 鼓 輪 垂 里 癮 生 福 子 垢 孔 塞 聽 鏡 套 聾 門 畔 鳴 熱 力 背 沉 洞 房 風 郭 際 尖 廓 科 麥 食 屎 順 飾 蝸 性 穴 音 針 墜 部 聰 殼 旁 石 栓 痛 炎 翼 罩 
值=得 錢 班 日 勤 的 此 當 更 守 夜 域 參 星 
習=慣 氣 俗 作 性 用 題 非 武 尚 得 染 好 見 藝 語 字 水 
留=下 心 學 神 戀 給 意 住 情 守 存 念 用 客 級 洋 宿 名 取 起 隊 點 言 影 任 駐 在 待 醫 了 作 難 有 著 足 校 美 個 空 到 得 步 置 香 傳 痕 日 英 班 別 成 底 都 居 門 題 職 針 種 滯 壩 辦 出 德 法 話 鳥 蘇 
桌=子 椅 面 布 燈 上 球 前 邊 巾 
引=起 用 導 誘 出 得 路 進 文 入 語 子 渡 申 逗 號 見 線 水 退 薦 言 力 擎 著 咎 信 爆 河 種 致 發 述 來 領 證 以 人 到 為 向 資 自 論 介 開 動 例 流 理 產 火 航 港 頸 酵 腳 橋 吭 燃 上 索 物 
印=象 度 刷 行 本 花 子 證 記 章 痕 發 制 數 堂 鑒 泥 歐 巴 譜 染 色 綬 信 張 尼 書 在 機 出 版 像 成 紐 鼻 次 跡 臺 鐵 璽 油 支 錯 模 紋 作 
存=在 心 款 亡 放 折 貨 戶 身 活 儲 為 疑 入 單 根 有 盤 于 取 量 水 著 留 檔 了 下 錢 貯 續 案 糧 念 查 車 貸 底 積 據 歿 期 食 世 息 項 蓄 照 正 執 數 
興=奮 趣 邦 味 致 起 頭 隆 亡 旺 盛 建 辦 學 衰 修 許 業 華 國 縣 工 寧 嘆 兵 革 師 安 海 和 化 平 仁 山 文 義 
危=險 機 急 難 害 亡 及 局 崖 殆 樓 房 厄 城 篤 改 懼 境 淺 途 象 言 重 坐 
充=滿 分 實 足 當 饑 塞 溢 軍 公 沛 斥 數 任 裕 盈 份 電 氣 水 血 作 暢 填 值 
肚=子 皮 臍 量 痛 兜 腸 帶 里 
脾=氣 胃 性 臟 炎 寒 
法=子 國 律 文 師 官 庭 則 院 幣 寶 術 門 令 語 事 辦 郎 人 制 場 度 權 定 治 規 家 學 名 器 案 紀 警 力 中 條 衣 典 網 書 理 號 帖 旨 例 輪 拉 相 式 醫 身 老 蘭 方 王 商 外 眼 務 螺 槌 徽 古 甲 盲 統 兒 爾 服 官 系 線 
居=然 住 民 多 士 于 留 中 功 左 右 委 屋 所 首 家 室 處 高 心 里 官 間 積 奇 喪 前 先 
各=種 處 人 國 自 地 個 樣 位 界 族 級 別 鎮 章 型 顯 持 項 區 類 大 方 有 式 報 科 部 組 家 具 款 一 省 占 站 班 業 派 異 路 條 得 隊 院 市 色 縣 為 系 盡 門 黨 不 用 鄉 代 半 說 戶 行 村 
勉=強 勵 力 
祖=父 國 母 宗 先 師 傳 墳 孫 籍 上 輩 業 德 訓 廟 本 產 率 居 塋 制 
戀=愛 人 歌 情 母 上 曲 棧 慕 念 舊 家 群 戰 
犧=牲 
依=然 舊 靠 照 賴 據 附 次 法 從 仗 紀 存 托 循 歸 此 戀 序 稀 偎 山 約 隨 傍 人 憑 順 違 允 安 蘭 
舒=服 適 暢 展 坦 心 活 淇 緩 泰 曼 高 卷 散 聲 爽 婷 徐 張 城 
平=常 日 靜 時 等 凡 安 民 原 衡 地 均 仄 坦 生 淡 和 素 穩 庸 津 面 聲 分 臺 板 息 易 定 房 行 正 價 頭 金 輩 反 滑 復 實 視 整 川 裝 緩 昔 信 順 江 妥 方 角 臥 展 服 壤 手 爐 魚 的 倉 治 路 度 絨 放 底 添 鍋 足 湖 白 布 動 頂 直 一 山 年 亂 列 流 版 槽 產 車 疇 調 旦 糴 毀 光 谷 局 靖 級 曠 闊 米 明 叛 盤 鋪 權 身 伸 射 糶 攤 紋 西 心 巷 銷 移 衍 野 議 抑 月 允 陽 作 壩 昌 成 伏 果 降 利 涼 魯 陸 南 泉 潭 塘 躺 武 鄉 遙 邑 陰 輿 遠 
顯=得 然 出 示 明 露 著 現 赫 眼 貴 存 要 形 影 見 微 圣 性 揚 靈 榮 學 像 卡 能 擺 達 豁 宦 目 位 效 耀 證 型 職 祖 
椅=子 墊 套 披 背 
未=必 免 來 曾 能 嘗 始 知 經 了 定 決 遭 予 晚 計 斷 遂 有 見 完 被 受 盡 到 得 滿 可 婚 及 成 開 明 幾 收 變 用 做 聞 果 然 料 按 交 向 卜 消 干 嫁 走 詳 寫 便 竟 時 央 熟 準 泯 
始=終 祖 末 建 于 創 發 知 皇 料 而 業 
奶=媽 娘 油 粉 頭 茶 氣 爸 罩 水 牛 皮 糖 牙 名 品 瓶 地 酪 瘡 糕 毛 羊 嘴 子 汁 
口=氣 袋 號 吻 音 頭 語 味 角 紅 水 舌 子 令 才 風 實 述 哨 試 齒 供 琴 信 腔 岸 福 腹 訣 罩 碑 傳 授 徑 糧 臭 沫 銜 稱 技 蘑 譯 瘡 緊 形 的 中 感 服 渴 部 里 交 內 誦 算 吃 唇 干 杯 北 彩 淡 惠 角 噤 快 馬 器 輕 條 誤 外 腕 型 小 諭 重 占 兒 蓋 炎 緣 
連=忙 聲 載 續 累 環 著 接 夜 同 天 日 作 貫 年 珠 用 鎖 部 枷 隊 襟 通 云 臺 機 呼 號 根 負 讀 任 桿 翹 串 帶 番 戰 在 網 上 成 城 山 敗 綿 勝 署 到 開 篇 個 理 體 發 你 生 合 平 冠 心 坐 贏 名 選 詞 喊 看 播 霸 闖 亙 擊 長 筆 氣 手 寫 音 綴 遭 種 軸 比 唱 乘 禱 江 凱 南 片 橇 賽 射 投 線 元 運 
神=氣 秘 巫 情 圣 經 仙 話 色 奇 往 明 態 靈 像 曲 父 志 思 學 怪 龕 廟 韻 妙 州 通 女 童 力 權 采 速 人 位 威 交 異 智 化 馬 貓 犬 罰 作 品 聊 物 效 的 戶 會 功 偷 職 龍 探 教 殿 性 醫 勇 舟 似 社 兵 跡 武 道 壇 農 游 算 奧 筆 馳 燈 魂 垕 漢 乎 侃 拼 婆 ? 器 傷 髓 悟 宇 主 池 恩 法 格 棍 技 劇 駿 迷 名 木 水 喻 只 諭 
目=的 前 光 標 錄 睹 送 擊 視 力 次 露 測 中 下 論 眩 鏡 黑 見 今 語 
毫=無 不 毛 克 米 升 厘 子 發 秒 安 分 伏 末 洋 針 巴 法 亨 瓦 
安=慰 靜 排 全 心 置 定 徽 穩 詳 放 分 頓 寧 息 閑 上 樂 然 好 睡 眠 逸 插 身 生 葬 家 歇 撫 康 危 裝 謐 能 陽 度 神 培 居 娜 在 達 坐 得 于 妮 泰 南 琪 利 和 西 享 平 迪 保 設 國 人 營 民 恙 東 檢 慶 邦 打 適 吉 順 拉 厝 抵 堵 可 寢 恬 帖 妥 臥 源 枕 扎 步 貧 胎 產 多 福 化 慧 了 陸 曼 內 丘 塞 圖 溪 縣 鄉 遠 岳 澤 祺 
少=年 爺 女 數 有 見 婦 許 校 量 尉 兒 來 保 將 于 的 了 林 得 男 壯 吃 時 說 些 則 賺 受 發 禮 管 刻 陪 頃 相 走 艾 掉 東 額 搞 扣 賣 奶 奇 帥 小 陽 
提=出 起 到 高 倡 議 醒 供 防 拔 前 煉 早 案 示 綱 琴 要 升 籃 名 箱 包 燈 取 盒 審 法 問 督 花 款 些 請 手 純 交 級 及 過 點 著 價 子 貨 攜 單 神 桶 存 干 筆 訊 溜 留 任 梁 拉 成 詞 兜 調 行 婚 灌 親 挈 速 現 選 制 職 論 喻 
左=右 手 邊 翼 側 面 派 傳 端 擊 拉 移 胸 腦 路 角 拐 半 輪 券 腳 上 下 鍵 方 轉 眼 的 臂 腿 耳 掌 近 聯 肋 傾 遷 權 首 袒 舷 
組=織 成 合 稿 胺 里 配 圖 工 員 閣 畫 建 別 曲 件 委 裝 團 隊 分 歌 態 字 詞 辦 編 銼 雕 詩 長 
群=眾 山 星 體 峰 落 芳 情 島 雄 賢 團 聊 交 架 像 組 起 英 居 臣 射 舞 聚 集 小 毆 力 唱 雕 婚 氓 青 蛀 發 里 論 
音=樂 譯 節 調 響 符 韻 律 信 容 訊 階 變 義 問 波 讀 兒 量 色 標 塵 形 軌 像 域 綴 叉 長 序 質 效 頻 區 箱 源 速 帶 程 耗 高 碼 名 品 強 勢 素 位 息 型 系 協 障 值 準 感 
嘴=唇 巴 角 邊 臉 部 皮 穩 里 上 軟 笨 饞 刁 乖 緊 尖 快 勤 碎 松 損 甜 頭 硬 嚴 直 子 
沉=默 重 吟 靜 思 悶 著 醉 痛 浸 溺 沒 穩 郁 睡 淪 毅 淀 湎 迷 浮 掉 積 陷 降 渣 ? 雷 冤 寂 船 香 實 入 落 底 酣 緩 痼 井 綿 埋 雄 抑 勇 滓 滯 床 隆 潛 下 
去=年 世 掉 處 路 職 聲 爭 了 的 做 看 到 找 買 過 除 愛 向 玩 吧 見 不 想 也 留 聽 得 吃 死 皮 拿 就 改 函 哪 辦 干 磁 垢 住 殼 斑 污 勢 任 日 點 冬 火 非 國 秋 暑 歲 雄 碰 查 膠 角 痛 夏 脂 
計=劃 算 較 策 議 數 謀 量 時 分 有 入 委 費 價 票 稅 提 酬 件 生 工 溫 
分=鐘 明 別 析 子 開 量 外 辯 為 配 會 手 成 頭 散 離 家 類 得 擔 寸 裂 數 辨 心 享 布 歧 解 派 居 送 發 割 工 段 之 化 界 身 泌 清 號 野 曉 隔 攤 店 憂 組 贓 期 場 局 娩 秒 批 紅 機 設 院 支 制 省 舵 房 赴 部 等 隊 洪 流 冊 母 區 陰 的 銷 拆 級 校 項 層 有 社 科 給 出 體 站 到 作 屬 貝 列 時 地 檔 蘗 班 文 立 點 館 水 租 獲 頁 述 權 包 克 理 宜 毫 來 色 道 錢 叉 占 合 劇 內 管 封 式 生 說 治 句 廠 值 錄 欄 力 餾 潤 撥 幣 保 兵 爨 餐 詞 行 飛 肥 卷 際 揀 米 袂 片 頻 神 則 賬 診 步 岔 帶 掉 度 光 集 節 塊 利 路 屏 升 腿 選 載 灶 枝 裝 走 岐 
遇=到 見 害 難 險 救 刺 上 有 襲 著 事 剌 合 敵 
況=且 味 
愛=情 國 人 好 護 惜 憐 慕 撫 憎 戴 心 女 戀 神 稱 妃 樂 郎 機 喝 犬 的 上 你 我 是 他 得 到 子 著 之 美 意 過 她 吃 看 侶 河 民 家 小 恨 玩 妻 了 聽 蓮 車 將 生 說 昵 做 才 書 笑 欲 哭 物 不 徒 起 多 巢 崗 嬌 卿 死 財 唱 蟲 錯 打 帶 黨 動 讀 惡 給 姬 拼 錢 去 校 華 見 教 馬 染 鄉 畜 液 走 
環=境 繞 抱 顧 子 節 視 保 縣 流 球 形 城 路 行 游 烷 山 島 海 區 狀 道 列 靶 襯 合 礁 生 食 烴 衛 線 指 志 帶 水 伺 
交=給 情 際 代 通 換 涉 流 談 往 易 出 叉 替 付 戰 織 錯 還 游 界 互 誼 貨 加 手 差 道 融 鋒 集 接 工 好 口 邊 心 點 納 媾 班 火 回 投 予 友 匯 到 會 稅 椅 警 大 上 托 與 費 配 電 響 稿 錢 保 惡 疊 底 售 合 聯 歡 割 款 辦 相 行 車 臂 拜 兵 并 杯 瘁 輝 活 管 公 關 結 九 卷 角 困 迫 權 尾 卸 映 賬 雜 城 風 感 
內=容 心 地 部 外 行 戰 閣 室 在 幕 侄 亂 疚 情 政 務 衣 蒙 奸 臟 助 科 兄 向 涵 江 應 海 訌 河 鬼 射 線 定 功 傷 參 耗 存 服 景 力 秀 因 弟 難 能 親 勤 有 置 文 人 設 里 含 陸 藏 需 褲 銷 資 附 經 側 中 頁 裝 分 收 主 化 賓 艙 省 壁 碼 轉 熱 門 層 傳 斂 環 澇 聯 焰 面 核 網  湖 詳 積 嵌 蘊 膜 耳 控 膽 測 瓤 場 臣 城 盜 稃 封 畫 踝 患 顧 急 眷 徑 角 刊 愧 貿 皮 潛 傾 遷 侵 水 調 胎 廷 退 衛 陷 憂 債 招 子 痔 宅 障 爭 阻 襯 丹 港 黃 聚 卷 流 囊 切 丘 圈 裙 審 史 視 庭 屋 鄉 項 野 圓 源 院 證 脂 制 質 酯 
由=于 此 衷 頭 他 我 來 你 人 誰 內 是 得 打 子 
背=后 景 著 影 心 誦 脊 面 書 叛 負 棄 包 運 部 離 時 靜 投 過 出 帶 簍 上 囊 痛 對 向 的 靠 起 對  光 信 人 榜 稱 風 貨 街 剪 靠 鰭 氣 熟 手 頭 興 約 陰 眼 債 子 板 袋 德 地 骨 簽 扇 下 斜 
寂=寞 靜 然 寥 滅 
醫=院 生 學 治 藥 科 療 書 師 道 務 士 術 患 保 護 理 德 囑 方 用 界 家 圣 壇 大 風 
休=息 養 想 假 止 憩 戰 姆 矣 學 會 閑 業 整 市 克 班 庭 兵 耕 咎 刊 眠 戚 妻 書 漁 道 怪 去 說 寧 
整=個 天 齊 理 潔 頓 體 治 套 數 風 建 容 備 編 修 地 黨 機 形 合 的 晚 日 條 蠱 年 座 夜 改 篇 幅 肅 隊 塊 除 版 頁 人 兒 料 流 補 飭 點 復 固 句 紀 垮 錢 式 飾 宿 托 訓 月 裝 枝 車 船 發 骨 軍 臺 型 周 
兄=弟 妹 嫂 長 貴 臺 
失=去 敗 望 掉 業 蹤 眠 戀 落 意 聲 足 傳 火 陷 身 神 守 明 禮 節 信 學 言 手 地 態 散 勢 修 竊 迎 利 實 算 血 主 常 陪 職 調 控 靈 誤 約 寵 閃 事 重 效 真 物 當 衡 卻 聰 色 責 憶 球 禁 婚 分 配 時 盜 笑 所 語 措 策 察 單 德 和 范 歡 悔 敬 檢 腳 據 口 密 迷 群 墑 慎 收 水 體 音 著 準 格 計 蹄 諧 序 宜 貞 
宣=傳 布 言 告 揚 戰 稱 誓 讀 講 紙 泄 判 城 州 教 示 明 威 宗 召 武 筆 德 和 化 統 腿 恩 漢 王 
向=來 前 著 上 往 導 陽 例 心 他 外 下 學 西 東 北 后 南 日 左 那 內 右 海 隅 善 度 地 量 背 應 使 性 邇 里 火 秀 晚 慕 誰 斜 
滿=意 足 天 心 洲 懷 腔 眼 族 載 文 處 貫 額 桌 紙 期 分 的 地 有 后 布 身 是 臉 面 座 月 溢 口 堂 員 清 街 頭 屋 城 的 腹 目 人 擰 倉 點 服 共 江 門 勤 師 孝 嘴 潮 車 匙 出 眶 地 盤 園 
臉=色 孔 頰 盆 面 皮 龐 子 蛋 譜 相 盤 膛 容 形 型 軟 上 部 紅 兒 大 厚 
翻=譯 身 開 閱 臉 騰 印 滾 轉 案 動 新 飛 砂 車 悔 修 天 入 炒 倍 改 版 蓋 地 查 看 建 耕 尋 覆 船 倒 出 過 沉 到 起 頁 錄 領 弄 本 唱 場 斗 番 黃 供 工 檢 漿 卷 刻 毛 拍 盤 皮 升 曬 土 胃 越 涌 造 辯 掉 上 書 下 
絕=對 不 望 跡 交 妙 地 句 食 口 技 路 境 緣 壁 響 筆 唱 配 贊 密 藝 種 活 癥 學 招 無 非 大 世 佳 倫 情 了 代 色 頂 版 育 難 熱 然 產 倒 后 好 戶 經 門 滅 品 嗣 劍 收 續 徑 美 命 殺 俗 
劇=本 烈 場 團 情 院 種 目 痛 組 照 毒 務 中 增 作 變 壇 減 評 社 協 終 降 校 
商=量 人 議 店 務 業 會 品 榷 船 標 定 場 談 討 賈 埠 情 行 酌 周 委 圈 隊 洽 販 港 丘 社 約 貿 機 戶 界 用 鋪 廈 家 報 號 科 譽 代 城 數 檢 旅 展 洛 朝 鞅 戰 路 辦 兌 調 海 法 購 館 計 稅 團 亭 攤 都 河 群 水 圖 州 祺 
三=月 國 角 弦 節 輪 藏 寶 七 伏 思 叉 好 星 昧 皇 副 軍 玄 棲 姑 幅 冊 遍 龍 槍 叔 秋 板 相 十 個 年 日 百 次 千 四 號 種 天 位 分 期 人 時 項 大 萬 成 樓 季 點 條 級 歲 院 九 章 者 屆 億 八 代 部 五 類 方 層 份 是 臺 倍 地 中 聯 只 元 頁 菱 段 通 公 度 圍 世 線 張 峽 色 步 所 有 重 班 面 下 甲 小 維 周 餐 套 等 則 門 兩 講 變 番 毛 洋 關 亞 顆 陽 水 回 尺 無 更 任 環 金 陪 原 生 邊 明 打 街 夏 資 流 股 多 顧 寸 疊 會 亂 包 北 產 朝 春 害 反 防 焦 鍵 清 制 鮮 月 廢 瓣 伯 弟 定 高 哥 光 極 江 杰 姐 晉 絕 老 麥 強 秦 穗 態 同 正 
笑=話 容 臉 意 語 紋 影 柄 貌 談 劇 料 窩 迎 穴 了 顏 納 說 的 著 了 聲 道 得 我 面 你 出 看 傲 翻 場 死 噱 罵 氣 星 靨 鬧 煞 一 
漂=亮 流 泊 浮 白 染 兒 洗 游 洋 移 到 過 礫 往 著 
著=急 呢 手 眼 想 實 落 重 火 涼 慌 迷 色 筆 力 意 裝 陸 數 魔 哩 的 地 墨 想 惱 落 邊 床 調 法 家 忙 色 地 述 
姐=妹 夫 弟 兒 們 丈 
趕=快 緊 到 上 忙 回 走 路 車 場 早 集 巧 跑 赴 趟 往 超 出 來 在 著 去 工 制 過 奔 點 海 汗 勁 腳 街 考 寫 圩 活 
光=明 景 榮 輝 陰 緒 彩 亮 線 芒 滑 棍 華 澤 照 顧 頭 復 臨 耀 潤 圈 潔 焰 大 波 氣 帶 憑 腳 儲 刃 學 電 溜 能 度 熱 源 面 譜 速 環 盤 的 驅 年 是 影 標 纜 說 子 碟 涌 束 著 心 控 柵 靠 鮮 火 良 療 斑 筆 板 赤 寵 燦 刀 導 刻 敏 球 纖 禿 艷 洋 暈 柱 軸 唱 程 吃 點 喝 闌 輪 前 強 山 武 像 州 
產=生 業 物 品 婦 婆 院 科 量 兒 房 前 地 權 床 鉗 后 值 銷 能 出 于 假 子 自 區 卵 油 糧 程 道 煤 期 仔 額 米 乳 褥 險 
全=國 部 身 體 都 集 書 然 面 力 村 盤 副 文 場 局 數 班 能 會 球 盛 貌 權 景 民 新 軍 廠 線 長 稱 年 才 屏 碼 服 行 字 程 票 食 托 殲 速 港 日 是 校 職 人 資 無 美 套 家 省 不 城 靠 市 名 心 由 天 被 隊 臺 勝 區 車 劇 裸 額 責 真 篇 縣 本 黑 組 異 境 院 對 開 員 信 脂 等 黨 拼 角 滅 解 活 路 豹 般 傳 好 份 乎 價 麻 勤 色 息 休 鄉 蝎 優 有 月 音 怪 椒 委 險 形 域 鎮 州 
五=月 四 彩 官 一 行 經 毒 指 谷 帝 臟 金 倫 星 音 岳 律 味 旬 刑 方 十 分 年 日 個 時 百 千 六 萬 歲 大 人 天 成 位 號 樓 次 點 三 七 種 倍 屆 中 層 代 場 香 臺 色 小 洲 周 更 內 常 華 國 福 筆 愛 嶺 保 好 葷 古 絕 峰 霸 報 反 服 關 湖 里 蓮 龍 雙 羊 夜 
互=相 助 通 換 譯 認 道 保 翻 讓 勉 利 聯 動 補 惠 信 連 為 愛 不 訪 選 有 借 諒 生 用 見 傳 溶 斥 感 濟 派 設 訓 余 贈 祝 質 幫 毆 鎖 
麻=煩 子 雀 將 木 醉 繩 袋 痹 布 油 花 利 臉 醬 紗 線 黃 藥 質 豆 包 石 風 辣 疹 紡 省 衣 垌 刀 搗 稈 黑 亮 糖 城 點 江 
害=怕 羞 臊 人 病 處 蟲 鳥 死 得 你 己 口 命 喜 眼 苦 
戲=劇 曲 臺 院 子 法 文 詞 謔 班 迷 目 碼 耍 言 本 裝 珠 照 中 水 弄 票 服 路 稱 里 樓 場 單 歌 評 說 侮 衣 
加=上 以 入 倍 工 強 緊 重 深 之 快 速 薪 大 意 冕 高 油 害 班 劇 寬 料 形 爵 血 農 法 固 盟 密 熱 急 數 號 力 侖 了 價 的 息 一 州 添 在 權 稅 多 到 碼 進 載 蓋 納 收 諸 長 水 減 于 給 派 鹽 沙 分 元 個 壓 我 點 溫 印 值 氣 厚 持 注 氫 演 護 成 殼 精 餐 封 勁 蓬 塞 刑 座 查 場 粗 墊 箍 掛 官 酒 亮 滿 蜜 彭 賽 鎖 洗 寫 汁 足 
勞=動 力 苦 駕 作 累 碌 資 工 役 頓 模 改 乏 績 保 方 教 金 傷 務 心 煩 損 神 爾 瘁 軍 師 逸 拉 支 
編=輯 者 成 入 造 纂 寫 制 譯 排 織 劇 撰 號 目 著 審 導 就 組 錄 配 碼 訂 印 曲 定 的 程 舞 余 為 列 委 修 選 在 班 繪 出 了 校 內 年 報 播 湊 創 次 隊 發 后 結 派 磬 外 演 鐘 綴 法 集 書 條 
證=明 據 實 人 書 章 件 券 言 物 詞 照 驗 婚 見 偽 
緣=故 分 由 起 于 何 石 法 
燈=光 火 籠 影 節 塔 罩 彩 泡 油 頭 盞 市 臺 謎 草 前 苗 柱 會 座 飾 箱 號 具 下 捻 蛾 標 池 虎 花 管 傘 絲 芯 燭 架 殼 語 展 
偶=然 爾 像 得 合 發 人 有 遇 一 數 或 犯 感 見 們 是 也 最 逢 
八=月 股 字 哥 角 一 卦 仙 旗 節 里 十 神 年 日 十 時 個 百 九 號 六 五 成 歲 千 四 萬 七 條 點 名 億 折 位 分 屆 次 大 強 天 戒 種 方 部 度 場 級 層 音 倍 家 兩 開 塊 國 珍 段 路 版 朵 景 面 秒 旬 中 
討=論 厭 好 飯 伐 教 價 回 嫌 人 要 饒 擾 吃 還 米 平 情 乞 巧 俏 親 錢 債 賬 去 
科=學 舉 員 技 目 研 班 教 普 委 大 幻 系 隆 考 盲 爾 別 協 第 場 際 比 白 處 罰 級 甲 室 星 長 
陽=光 臺 歷 溝 間 傘 電 爻 界 關 平 文 性 極 面 韻 明 具 江 物 剛 宅 氣 萎 春 狂 坡 泉 畦 世 壽 燧 朔 線 虛 城 高 谷 曲 山 新 信 原 
遠=處 近 方 大 望 行 景 道 房 離 東 游 客 親 見 門 征 路 足 慮 因 志 祖 視 洋 航 謀 的 比 程 了 在 眺 期 古 去 走 山 播 地 之 射 銷 遁 渡 非 海 隔 郊 涉 揚 安 避 別 到 端 發 華 嫁 南 逝 思 投 于 地 矚 
搖=頭 頭 動 晃 擺 籃 椅 尾 獎 滾 身 曳 臂 撼 手 耬 落 櫓 把 車 船 蕩 惑 蜜 漾 枕 出 錘 桿 槳 旗 醒 勻 
話=說 劇 語 題 頭 本 音 柄 別 筒 鋒 的 中 事 費 機 白 茬 舊 梅 亭 務 網 兒 頻 
校=長 門 園 對 舍 務 外 刊 址 勘 友 正 醫 訓 規 訂 歌 樣 方 風 官 徽 準 內 本 際 董 服 慶 隊 名 車 工 區 歷 史 辦 花 改 核 編 場 點 驗 閱 譯 注 容 齡 會 紀 尉 役 
南=京 方 北 邊 洋 下 海 面 部 昌 國 風 瓜 美 貨 極 疆 歐 亞 非 通 麓 園 油 線 都 到 川 沙 寧 區 韓 華 山 的 豐 路 天 大 有 投 宋 縣 市 端 岸 航 開 陽 街 朝 澳 移 丹 無 湖 遷 越 安 門 拳 粵 充 側 城 斗 宮 明 蠻 齊 曲 糖 頭 唐 緯 戲 音 苑 針 飛 關 郭 和 胡 匯 江 郊 康 口 樂 陵 嶺 皮 坪 平 人 味 溪 向 雄 巡 岳 漳 召 鄭 簏 
何=必 以 況 等 嘗 處 時 苦 妨 在 其 故 止 至 談 去 懼 愁 謂 種 不 解 方 地 為 來 事 人 能 意 用 日 者 干 須 需 如 物 曾 靜 足 年 難 琳 忍 啻 晴 往 許 樣 患 似 異 炅 
命=令 運 中 名 題 苦 意 脈 案 根 相 定 大 筆 婦 官 駕 數 途 門 喪 
更=加 為 其 新 正 夫 換 動 改 衣 迭 替 鼓 象 弱 累 生 多 有 是 大 能 好 會 高 深 佳 要 具 快 不 應 將 易 趨 強 難 甚 低 長 使 美 少 顯 需 早 添 讓 遠 須 受 嚴 名 全 糟 差 緊 臻 想 壞 短 輕 小 慘 近 穩 怕 定 熱 闌 變 次 番 始 香 張 黑 久 冷 亮 漏 妙 爽 細 優 圓 重 
贊=成 美 嘆 同 揚 賞 頌 助 許 歌 禮 語 譽 詞 和 佩 辭 皇 為 
改=變 造 革 良 進 正 編 善 天 動 換 用 口 過 稱 行 寫 組 日 嫁 選 悔 裝 建 觀 訂 制 嘴 字 大 一 出 期 道 任 判 型 為 名 成 了 作 在 版 途 線 錯 掉 做 回 姓 扮 點 定 稿 醮 考 刊 頻 色 完 向 元 樣 易 轍 錐 種 短 屬 說 小 葬 則 鑄 
雜=志 文 亂 感 記 種 劇 貨 事 耍 院 念 談 碎 糧 務 物 草 拌 居 技 說 質 項 用 燴 毛 活 店 兵 音 費 史 交 家 面 品 錦 色 工 婚 處 糅 病 湊 沓 肥 件 木 牌 食 稅 書 壇 役 揚 字 癥 波 多 集 錄 訊 
秘=密 書 訣 史 方 笈 室 本 傳 技 籍 魯 寶 府 結 聞 藏 使 
價=值 錢 格 目 碼 款 位 廉 差 簽 高 
材=料 質 積 樹 種 
行=為 動 李 人 走 政 列 事 頭 將 船 徑 者 市 進 駛 裝 業 程 星 家 善 蹤 話 色 文 兇 車 軍 使 醫 囊 狀 當 賄 好 宮 情 間 書 規 號 啦 銷 販 會 述 幫 輩 貨 署 營 款 商 了 內 劫 經 路 騙 數 道 禮 都 刑 檢 止 好 旅 房 樂 乞 年 刺 速 數 距 伍 院 長 棧 獵 令 不 草 藏 端 道 腳 賈 楷 客 聘 竊 期 腔 篋 轅 員 約 舟 詐 板 筆 風 省 尾 
勇=敢 氣 士 猛 于 武 奪 者 將 力 斗 悍 決 毅 攀 為 
足=以 夠 下 跡 球 跟 尖 量 趾 彩 壇 聯 協 見 部 可 有 印 額 矣 本 月 金 底 歲 色 音 銀 
規=矩 定 則 律 模 勸 范 格 劃 程 章 避 約 例 費 誡 諫 勉 整 正 制 
妻=子 舅 兒 室 妾 女 孥 弟 姐 妹 小 兄 
火=車 光 柴 焰 爐 燒 把 星 腿 花 炬 山 氣 藥 盆 葬 苗 熾 力 線 雞 災 坑 勢 鍋 頭 箭 舌 種 場 堆 海 性 候 器 化 球 龍 槍 速 炮 并 鉗 棒  柱 上 魔 大 烤 燭 眼 繩 炭 險 石 網 暴 警 炕 印 爆 熱 紅 辣 機 中 源 鳥 鐮 亮 籠 捻 絨 輪 銃 刀 攻 罐 急 酒 具 媒 拼 情 漆 色 神 塘 燙 硝 針 紙 主 箸 狐 法 鶴 兼 堿 剪 控 蛇 
靈=魂 感 活 驗 堂 通 便 敏 巧 柩 光 牌 性 藥 位 芝 車 機 異 氣 山 塔 動 石 床 丹 慧 幡 符 府 怪 境 貓 妙 棚 寢 前 童 臺 透 秀 犀 智 肉 寶 壁 杰 媒 明 丘 壽 武 
唯=一 恐 物 心 有 獨 美 其 實 我 
玻=璃 爾 
鄉=下 村 親 民 里 紳 土 音 愁 鎮 試 思 鄰 談 誼 間 情 人 戀 辦 黨 丁 宦 姑 井 居 曲 俗 賢 愿 野 郵 約 長 城 關 級 寧 氣 勇 友 
暫=時 且 停 住 行 緩 定 扣 用 缺 不 未 無 別 借 存 居 短 減 留 態 
春=天 秋 風 節 光 雨 聯 寒 色 季 暉 假 意 蘭 雷 游 蠶 卷 夢 耕 心 夜 歌 麗 情 分 筍 裝 綢 凳 試 汛 運 夏 日 宵 旱 花 水 江 藥 泥 令 餅 潮 城 茶 初 畫 荒 肥 宮 景 末 上 山 條 頭 闈 訓 曉 雪 種 晚 衣 草 菇 紅 華 蕾 露 事 
照=例 顧 著 片 相 樣 應 料 亮 耀 辦 管 見 面 射 抄 明 準 看 直 會 壁  搬 發 常 在 舊 做 出 理 得 護 到 錄 此 臨 登 拂 付 排 說 實 映 用 眼 章 度 碼 學 
弟=兄 子 妹 婦 媳 
眾=人 多 怒 望 生 院 星 說 數 口 位 目 
收=拾 入 到 回 藏 集 獲 買 斂 場 成 容 據 復 條 割 養 縮 羅 效 發 留 聽 兵 取 費 緊 盤 編 錄 納 尾 購 秋 攤 支 看 攏 齊 付 心 工 繳 審 益 音 市 生 報 的 視 件 受 貨 起 款 錢 銀 下 服 信 押 稅 歸 放 塵 賄 口 進 好 網 禮 攬 殮 鐮 案 存 車 操 儲 訂 活 方 風 撫 匯 管 監 檢 沒 沒 拍 枰 篷 訖 清 尸 束 徒 托 文 悉 心 治 賬 住 執 載 摘 貯 腹 去 用 債 走 
傷=心 害 兵 感 痕 風 員 口 亡 寒 疤 殘 腿 眼 勢 愈 病 號 者 人 的 痛 了 及 得 身 悲 科 神 財 悼 耗 懷 情 生 逝 損 俘 食 
緊=張 跟 急 要 身 密 湊 縮 接 迫 鄰 咬 壓 裹 挨 俏 缺 貼 隨 握 扣 的 閉 抱 繃 靠 逼 盯 蹙 促 催 地 鎖 實 著 地 縛 固 挾 抓 追 
城=市  門 樓 堡 頭 根 鎮 郊 池 鄉 垣 府 區 郭 關 網 寨 廂 防 中 里 內 建 外 邑 南 西 下 東 主 北 雕 垛 壕 隍 管 際 腳 闕 鐵 址 邦 堤 固 堞 
盡=管 力 量 情 心 責 忠 快 先 享 染 覽 攬 早 速 在 了 顯 頭 是 興 失 職 歡 數 孝 處 到 可 讓 然 憑 七 自 
新=聞 鮮 年 娘 詩 書 生 月 式 郎 奇 近 潮 人 房 興 婚 穎 疆 法 婦 作 政 型 兵 軍 交 異 村 手 教 安 化 藥 葉 貼 羅 蕾 課 老 星 秀 樓 苗 址 巧 風 品 的 界 一 增 低 華 舊 會 知 意 建 科 股 城 來 成 車 高 片 任 站 設 學 報 版 款 亞 歌 力 機 春 港 進 約 貨 編 貴 碟 竹 裝 劇 浪 制 路 黨 屋 貌 校 田 居 招 歡 店 派 詞 民 出 光 造 事 雅 到 辦 創 衣 宿 海 論 昌 寵 區 豐 買 禧 和 家 主 郵 顏 曲 官 張 野 館 語 添 歲 字 說 綠 銳 幣 茶 寡 秋 帖 特 鄉 余 義 雨 芽 正 著 姿 樂 晴 妝 賓 蔡 都 干 河 花 津 刊 龍 寧 邵 泰 縣 線 修 醫 沂 源 鄭 枝 州 洲 
窗=外 戶 子 口 簾 臺 紗 洞 欞 框 帷 沿 扇 花 前 體 門 內 扉 幔 式 板 飾 銷 檐 
腳=步 下 尖 跟 印 夫 趾 鐐 心 板 力 氣 本 盆 掌 傷 程 丫 爐 燈 注 踏 底 上 架 踝 輪 背 凳 法 勁 扣 面 蹼 錢 癬 爪 鐲 爪 邊 釘 手 韻 
利=用 益 害 落 于 息 己 器 潤 錢 索 誘 弊 率 好 國 空 多 馬 他 人 民 市 刀 尿 淡 劍 金 刃 箭 祿 導 鈍 滾 口 權 稅 欲 嘴 爪 昂 差 齒 津 辛 源 
哈=欠 日 韓 達 鏡 佛 尼 特 巴 兒 笑 密 氣 腰 代 吉 克 喇 雷 羅 桑 市 維 
愉=快 悅 
親=戚 切 熱 自 友 近 密 眼 家 人 事 手 昵 身 生 筆 屬 愛 吻 口 信 情 族 王 耳 臨 朋 歷 眷 兵 聆 如 率 夫 緣 子 的 民 疏 善 收 嘴 和 見 娘 本 傳 代 等 睹 丁 故 家 隨 天 體 魚 政 征 知 炙 貴 將 美 日 聞 
題=目 材 詞 名 字 詩 跋 寫 解 為 旨 庫 意 額 壁 海 花 記 簽 型 畫 款 
剩=下 余 的 磁 飯 菜 
刊=物 載 登 印 號 頭 出 發 授 用 行 本 布 刻 名 首 
睡=覺 眠 衣 夢 醒 意 椅 鄉 蓮 好 態 魔 袍 相 袋 褲 房 了 在 得 前 到 去 帽 吧 過 姿 容 裙 熟 下 眼 著 覺 獅 足 
招=呼 待 牌 手 惹 致 展 集 架 生 供 數 收 引 考 徠 兵 攬 募 貼 認 手 子 領 之 了 行 工 聘 事 標 股 商 租 來 式 兒 請 魂 人 安 納 辦 風 撫 法 喚 幌 干 盤 親 降 賢 搖 眼 贅 災 弟 福 回 遠 
建=設 筑 立 議 國 造 成 樹 都 交 蘭 黨 制 的 構 屋 于 材 有 業 校 華 置 邦 了 功 中 寧 言 檔 廠 起 平 安 房 庫 軍 好 文 委 德 康 和 站 行 白 倉 江 模 團 院 元 賬 昌 工 管 湖 始 水 網 武 陽 政 甌 
謝=意 絕 罪 頂 電 東 幕 恩 了 你 您 過 遜 禮 客 世 
享=受 樂 福 用 有 年 譽 盡 
帶=來 有 領 子 頭 兵 勁 動 路 離 毒 隊 著 給 出 到 同 走 回 你 我 了 點 上 進 入 他 一 去 往 菌 過 病 寬 引 大 電 血 下 薪 狀 傷 個 練 班 操 話 壞 化 環 飯 鋸 皮 挈 球 錢 槍 團 魚 音 職 植 刺 刀 道 鋼 工 好 扣 累 藥 
仔=細 畜 獸 魚 豬 雞 
七=月 一 大 絕 律 竅 旬 喜 十 年 日 十 時 個 百 五 成 九 千 歲 點 號 八 天 萬 名 人 億 位 樓 屆 次 項 彩 折 種 分 級 層 節 星 段 倍 寶 色 公 度 情 夕 寸 古 月 尺 臺 雄 
四=月 川 面 周 處 方 下 季 肢 時 書 海 壁 散 鄰 邊 聲 化 因 碼 合 幅 則 十 個 日 年 百 五 千 至 大 次 位 歲 成 項 九 號 種 人 章 億 樓 天 萬 點 小 屆 三 一 分 部 通 六 級 出 份 節 星 類 圍 座 層 角 起 是 班 強 射 輪 口 段 度 色 句 隊 對 代 有 美 步 平 眼 科 國 兩 開 重 套 濺 溢 維 顧 房 會 路 十 害 伏 胡 舊 郊 近 庫 旁 清 外 望 鄉 野 呼 講 絕 孔 史 體 喜 爺 音 
毛=病 巾 筆 蟲 發 線 孔 衣 蟲 雨 驢 毯 豆 利 票 竹 襪 皮 躁 刺 糙 桃 布 褲 坯 筍 重 色 氈 紡 細 選 料 呢 拉 藍 囊 寧 邊 草 茶 滌 孩 貨 蚶 估 茛 咕 尖 片 渠 頭 條 蝦 象 樣 腰 蚴 羽 賊 痣 豬 裝 子 卷 石 刷 織 狀 莨 
階=級 段 層 梯 乘 地 前 石 
據=說 點 守 報 悉 稱 此 聞 傳 有 實 理 查 
花=園 錢 朵 兒 樣 草 生 木 瓶 費 紋 瓣 環 邊 轎 炮 布 圈 卉 盆 壇 白 籃 臉 鳥 叢 插 匠 束 紅 圃 臺 子 旦 哨 色 蕊 市 呢 粉 房 心 冠 種 會 燭 農 燈 雕 招 苞 茶 槍 鏡 魁 蕾 鞋 眼 影 下 蝶 版 針 肥 銷 腔  絮 柄 車 梗 鼓 露 蜜 飾 絲 萼 椒 期 筒 押 磚 莖 托 了 的 上 在 名 旗 店 式 香 蓮 落 開 掉 簇 點 果 去 語 城 展 毯 軸 甲 王 光 枝 劍 樹 歷 藺 翎 令 容 斑 菜 池 緞 火 工 境 季 架 卷 酒 貓 拳 事 廳 序 線 項 信 朝 賬 障 柱 片 前 云 彩 癡 帶 道 都 國 黃 鍵 徑 俏 頭 葉 衣 垣 
匆=促 忙 遽 
畢=業 竟 生 至 升 露 節 直 
悲=哀 劇 觀 慘 痛 傷 壯 涼 苦 嘆 歌 泣 情 憤 慟 喜 悼 憫 愴 楚 愁 歡 號 鳴 切 凄 戚 聲 酸 辛 咽 感 恨 啼 哉 
干=凈 嗎 部 脆 涉 事 活 燥 勁 媽 笑 枯 糧 擾 校 草 果 涸 練 預 杯 癟 戈 娘 系 菜 親 掉 支 旱 薪 巴 飯 才 將 酪 休 鮮 堤 冷 路 粉 渠 洗 瘦 線 的 犯 爽 貨 嘛 了 群 濕 性 道 餾 出 啥 過 渴 澀 政 死 啤 流 裂 礙 禮 連 祿 白 板 貝 冰 城 柴 等 爹 花 嚎 號 紅 股 警 嚼 急 架 結 酒 咳 面 尸 松 啞 謁 仗 租 吧 點 肥 好 嘔 肉 時 縮 土 完 邑 制 著 
極=了 其 力 端 為 點 度 光 地 慢 處 限 刑 品 量 大 具 高 速 少 佳 有 低 富 多 難 不 易 強 差 盡 好 深 短 快 微 小 致 樂 權 性 惡 板 盛 右 目 細 壞 嚴 是 頂 化 口 缺 圈 夜 意 至 左 晝 值 長 肥 冷 面 熱 瘦 想 
譬=如 喻 方 
此=外 時 后 刻 間 言 行 前 致 則 在 藥 謂 論 列 項 處 事 類 等 舉 種 案 文 次 乃 地 書 情 人 即 生 法 片 病 表 道 心 話 理 際 番 意 曲 條 例 信 中 物 去 君 路 詩 風 帖 音 岸 恨 
諷=刺 喻 讀 諫 經 誦 
屬=于 實 地 下 國 性 相 望 狗 
破=壞 爛 碎 產 舊 綻 滅 裂 例 除 費 曉 獲 門 格 損 案 土 戒 鑼 空 殼 洞 財 處 相 解 了 口 譯 密 冰 落 陋 浪 臉 敗 壁 鈔 讀 腹 句 擊 墨 題 涕 五 鞋 顏 約 布 車 船 瓜 減 開 面 廟 皮 片 
轉=身 動 向 移 眼 變 念 入 彎 換 機 為 口 折 載 告 角 化 瞬 運 達 交 業 述 圈 給 賣 手 戰 送 椅 學 盤 車 貼 俏 暖 區 筆 讓 正 注 道 嫁 子 播 義 租 產 發 臺 型 到 售 會 用 而 賬 職 好 頭 成 弱 回 校 去 過 行 速 任 接 出 數 寄 強 制 來 爐 得 法 世 生 錄 船 軌 譯 贈 上 晴 調 借 銷 年 臉 鈴 輪 包 存 場 抄 遞 戶 崗 干 港 筋 幾 科 門 磨 遷 帖 體 天 托 梯 文 系 寫 悠 院 引 韻 一 軸 診 導 度 舵 矩 喻 座 圜 寰 
皇=帝 上 后 宮 室 家 冠 歷 朝 族 位 子 權 儲 莊 天 糧 城 甫 馬 親 統 都 軍 
增=加 多 高 長 添 進 刊 減 強 產 補 光 援 大 訂 殖 益 創 持 設 生 收 值 至 幅 撥 資 建 速 選 量 派 壓 刪 廣 發 盈 開 效 白 兵 調 輝 虧 色 損 溫 印 支 重 場 城 容 
腦=子 袋 筋 門 海 殼 膜 力 漿 髓 際 汁 瓜 炎 部 中 科 后 內 顱 兒 瘤 量 干 橋 勺 室 病 波 癱 
勢=力 必 頭 能 派 將 下 利 態 要 
越=來 發 是 過 南 加 軌 界 劇 級 要 弱 淡 后 聽 看 獄 多 大 高 野 好 洋 快 少 戰 遠 低 想 有 境 小 能 位 出 權 慢 短 嶺 來 早 禮 冬 多 分 快  職 吉 矮 長 共 瓜 壞 軍 線 秀 走 
胡=子 同 鬧 說 亂 琴 須 扯 來 椒 桃 言 話 麻 混 特 戈 豆 楊 吹 匪 蜂 攪 嚕 人 兵 編 纏 搞 瓜 歌 笳 靜 軍 侃 駢 荽 謅 家 斐 鍛 桐 
六=月 朝 畜 代 書 甲 年 日 十 個 時 百 歲 千 點 七 四 九 萬 五 成 條 號 位 億 次 人 樓 一 天 屆 大 分 種 級 和 部 度 合 國 經 根 周 祖 藝 親 路 安 輪 壬 腑 神 欲 害 盤 套 旬 枝 
古=代 人 怪 典 文 老 玩 董 書 物 詩 跡 城 時 裝 語 籍 雅 風 舊 巴 話 字 琴 板 拙 樸 奧 都 方 宅 諺 音 田 箏 今 道 墓 猿 堡 廟 法 龍 來 松 錢 稀 銅 樂 國 鎮 井 幣 ? 畫 柯 曲 剎 尸 藤 體 訓 昔 遠 宇 月 冢 納 意 本 墳 浪 名 木 史 藺 
媳=婦 
二=月 老 者 門 黃 房 心 話 胡 副 娘 筆 章 炮 十 年 日 千 百 時 三 手 人 樓 萬 次 七 期 九 是 號 八 級 歲 一 點 五 條 分 元 世 成 位 來 屆 度 奶 線 類 層 代 則 女 等 用 板 班 倍 審 戰 哥 連 回 進 維 指 十 流 輪 弟 爺 鋼 忽 伏 乎 婚 姐 毛 汽 是 胎 弦 言 意 遍 舅 壘 
抓=住 起 緊 藥 瞎 鬮 賊 狂 好 飯 獲 到 舉 得 人 取 去 喲 撓 膘 兵 捕 差 賭 點 丁 哏 拍 手 圖 癢 周 走 出 斗 痕 來 牢 傷 握 
首=先 飾 都 領 長 要 尾 次 相 腦 席 肯 級 位 府 創 富 惡 批 演 倡 犯 頁 個 度 選 季 屆 歌 期 日 部 映 家 發 份 推 詩 張 字 場 任 例 名 輪 播 站 航 座 鋼 開 爾 詞 拼 車 飛 戶 付 功 告 揆 鎧 枚 汽 途 烏 義 戰 展 
九=月 州 泉 鼎 曲 次 宮 歸 表 龍 年 八 七 日 時 十 六 四 五 個 一 歲 成 千 百 條 號 折 點 屆 萬 億 章 位 天 分 大 種 中 江 段 霄 十 級 倍 品 重 歌 妹 族 難 角 孔 卿 臺 運 
農=民 村 會 業 場 夫 家 奴 具 歷 林 協 婦 舍 事 學 田 大 忙 戶 作 經 活 藥 墾 時 藝 莊 地 耕 產 諺 用 科 工 貸 機 行 人 辦 畜 電 話 技 貿 牧 膜 情 桑 閑 械 校 友 運 資 安 副 神 委 中 專 
旅=館 行 客 途 游 費 程 店 伴 居 社 歐 港 舍 人 鳥 次 順 團 長 日 大 美 鼠 資 
俄=國 文 頃 語 亥 軍 延 而 共 
沙=發 漠 灘 子 土 皇 地 場 啞 盤 石 丘 袋 包 礫 門 加 眼 塵 果 荒 田 洲 俄 彌 層 蟲 龍 嘴 特 拉 灣 粒 泥 岸 壩 堆 河 林 鷗 梨 柳 暴 船 城 雕 海 化 獾 崗 金 棘 坑 磧 市 浴 災 柱 棗 障 栗 漏 禽 瓤 聲 響 聲 鼠 縣 質 
書=房 籍 店 桌 記 本 法 架 院 名 齋 生 報 包 目 信 畫 寫 面 頁 攤 櫥 香 屋 案 刊 評 后 箱 簽 柜 簡 稿 函 影 庫 皮 札 體 摘 市 冊 錄 童 背 展 眉 套 亭 物 中 局 訊 上 室 卷 商 館 社 里 林 單 友 海 號 吧 場 癡 丹 牘 蠹 販 荒 坊 翰 會 賈 家 口 迷 鋪 圣 肆 壇 心 協 證 蟲 夾 塾 
歐=洲 美 陽 冠 體 盟 元 陸 亞 式 姆 文 化 西 寶 風 芹 
欣=賞 然 喜 慰 然 悅 悉 忭 快 羨 幸 聞 
負=責 擔 有 荷 傷 載 債 重 數 義 約 面 上 起 的 累 片 笈 于 合 案 電 號 極 荊 疚 氣 屈 心 隅 罪 值 分 鼠 
懷=疑 著 抱 念 孕 恨 古 柔 想 表 舊 中 里 有 胎 安 德 仁 揣 戀 春 浦 素 鄉 化 集 寧 特 玉 遠 
送=給 禮 行 別 命 貨 親 藥 修 風 達 往 交 到 上 出 你 來 回 入 花 醫 去 走 電 煤 錢 飯 信 檢 人 死 殯 報 呈 還 發 股 客 氣 情 審 喪 戲 葬 終 站 展 錯 糞 經 糧 神 
帽=子 檐 盔 圈 耳 翅 徽 花 舌 沿 邊 頂 盒 章 
石=頭 青 階 子 板 榴 碑 印 像 刻 塊 橋 壁 灰 松 窟 柱 炭 竹 油 欄 膏 匠 雕  工 筍 鎖 版 磨 舫 鼓 器 料 墨 龜 坎 塔 筆 方 英 屏 蒜 ? 棉 蕊 化 灰 門 材 灘 獅 山 弓 林 人 室 龍 級 女 蠟 榴 城 埭 礅 擔 碓 墩 佛 斛 坊 貫 經 臼 硪 渣 清 蠶 槽 場 彈 峰 縫 斧 拱 棺 柜 徑 栗 籠 樓 煤 墓 牌 片 泉 首 臺 天 堰 狀 阡 
糊=涂 口 弄 狀 料  精 
哲=學 理 人 思 言 
性=格 情 質 命 急 子 欲 別 病 狀 行 能 具 腺 的 感 愛 交 事 向 趣 氣 器 靈 征 
錯=誤 過 事 字 亂 落 覺 怪 話 案 失 車 漏 的 了 配 愕 處 綜 位 用 愛 認 詞 訛 路 那 流 版 把 層 待 動 讀 峰 非 會 劃 號 放 分 告 季 金 將 節 開 看 謬 判 殺 題 填 退 寫 銀 雜 棋 筋 殊 譯 
獨=自 立 特 身 占 創 白 力 具 裁 唱 到 夫 吞 子 斷 霸 奏 守 闖 臂 愛 攬 苗 家 有 居 處 資 行 一 享 坐 得 尊 步 鐘 門 生 舞 龍 女 孤 個 體 院 眼 大 往 棟 活 眠 用 酌 
廚=房 子 師 藝 具 娘 司 衛 
普=通 遍 及 照 漲 賢 適 善 京 羅 查 選 世 爾 陀 米 渡 天 測 度 調 法 降 建 教 特 安 洱 高 格 九 拉 蘭 寧 
便=宜 道 利 于 當 飯 衣 了 裝 服 所 門 秘 條 捷 桶 壺 帽 覽 鞋 餐 盆 宴 可 會 是 不 要 能 有 成 應 將 把 被 說 與 向 去 攜 士 民 打 箋 溺 人 溺 步 車 池 函 橋 簽 血 中 了 血 又 酌 
領=導 袖 略 域 會 帶 子 到 悟 教 受 土 頭 事 取 隊 結 口 路 先 主 地 巾 章 海 空 班 獎 養 航 有 軍 回 著 扣 司 銜 唱 港 情 陸 辦 道 讀 花 鉤 館 工 江 款 命 跑 水 屬 舞 罪 奏 錢 圈 收 引 用 
兩=手 旁 邊 國 岸 面 者 頭 端 鬢 側 全 用 便 極 翼 批 畝 門 根 幅 番 頓 棟 朝 帖 米 棲 個 年 種 位 次 項 人 日 地 天 大 間 三 條 部 份 成 只 小 類 度 張 點 倍 件 場 句 性 套 層 周 家 千 段 百 隊 方 制 代 難 歲 座 黨 樣 顆 節 字 科 會 女 步 萬 級 臺 分 眼 下 月 漢 院 粒 腳 屆 股 季 道 對 枚 冊 半 勝 把 軍 路 腿 秒 頁 相 重 肋 訖 角 億 截 元 臂 口 課 肩 碗 省 卷 頰 廣 筆 市 回 包 行 立 利 彈 打 抵 湖 淮 江 晉 可 清 歧 廂 伊 造 遍 袋 朵 戶 基 聯 區 通 心 招 
嚴=肅 重 厲 格 密 正 守 酷 峻 謹 禁 寒 整 辦 刑 緊 詞 明 懲 防 實 打 冬 苛 加 父 令 管 控 命 師 霜 于 查 斥 責 陣 
伸=手 出 長 展 直 縮 張 延 向 入 進 開 腿 腰 曲 舌 頭 
脖=子 頸 
職=業 員 務 位 工 責 權 分 稱 守 銜 專 中 數 官 高 能 前 教 事 別 大 校 掌 改 介 司 
凡=是 事 人 需 被 例 爾 在 有 夫 屬 心 與 未 間 塵 俗 響 高 世 庸 
博=士 得 愛 覽 物 鰲 卡 格 彩 學 取 大 雅 客 采 導 古 識 聞 信 弈 引 白 達 動 斗 湖 局 樂 羅 野 
周=圍 刊 年 到 報 旋 身 末 游 密 全 轉 折 濟 正 莊 詳 邊 期 日 五 六 三 四 一 遭 易 知 歲 長 瑜 強 迅 薪 章 道 
幽=默 靜 怨 暗 雅 深 靈 情 谷 寂 香 禁 微 白 魂 期 趣 婉 門 美 會 冥 麗 閉 篁 憤 居 徑 眇 明 僻 囚 邃 思 嫻 遠 咽 憂 獨 夢 蘭 然 
抬=頭 舉 高 槍 肩 秤 價 筐 起 出 愛 盒 杠 腳 轎 裉 扛 升 手 眼 腿 
趣=味 事 聞 談 話 劇 
土=地 匪 人 話 語 壤  堆 改 產 著 布 山 坡 崗 豪 炕 木 坯 蜂 豆 法 貨 塊 質 坎 雞 城 里 溫 性 音 方 丘 棍 偶 星 物 葬 生 工 制 牢 牛 壘 壩 邦 鱉 包 堡 層 蠶 墩 肥 黃 房 風 蝗 埂 建 家 籍 筐 氣 司 色 俗 戲 腥 儀 藥 族 造 被 崩 糞 坑 路 石 灶 狀 
德=國 文 行 語 政 育 慶 昂 科 爾 望 州 昌 性 軍 安 法 比 操 才 宏 漢 甲 陽 治 瑪 方 化 江 欽 馨 
跳=舞 動 躍 板 蚤 水 高 臺 遠 槽 越 傘 樓 出 到 下 過 繩 上 起 的 進 入 蟲 跑 鼠 海 馬 票 梁 踉 班 蕩 行 河 級 腳 棋  神 箱 閘 讀 回 井 開 空 欄 離 球 投 線 針 轉 
健=康 全 壯 兒 在 將 忘 美 談 身 旺 步 體 行 碩 胸 朗 存 胃 
支=持 配 票 那 撐 援 使 流 出 部 書 柱 付 店 點 取 脈 架 路 前 座 隊 線 派 吾 助 承 離 棱 農 領 鏈 邊 絀 差 行 局 開 渠 紗 委 系 應 著 子 招 干 桿 護 起 樞 數 索 走 左 
手=指 段 絹 槍 帕 巾 臂 腕 心 腳 下 掌 法 續 藝 杖 表 勢 背 足 套 頭 筆 術 稿 工 鐲 跡 雷 氣 紙 面 印 搖 銬 冊 書 車 電 記 板 本 抓 辦 牽 懶 熟 刀 眼 癢 淫 諭 鼓 爐 戳 語 機 提 上 中 持 袋 里 寫 動 部 球 軟 拿 握 把 挽 肘 推 柄 繪 感 則 鏈 札 相 邊 令 拉 挽 環 緊 快 輕 輪 辣 鑼 把 版 包 抄 創 釧 長 錘 大 短 黑 扶 技 卷 鋸 慢 民 模 巧 勤 旗 生 松 談 紋 癬 攜 重 閘 澤 植 斧 控 剎 爪 鉆 睥 
月=亮 刊 光 報 色 牙 臺 底 夜 餅 中 份 薪 季 琴 初 宮 食 球 老 華 輪 暈 眉 落 給 錢 終 令 息 經 歷 相 票 石 的 內 后 前 費 號 租 結 明 出 間 入 會 下 尾 圓 分 末 震 影 工 利 頭 事 半 例 白 產 城 度 環 桂 均 考 杪 壇 夕 子 齡 神 盈 俸 
固=然 定 執 有 守 體 始 網 醇 態 本 頂 化 陋 辭 氮 防 件 結 沙 相 原 安 著 
夏=天 日 季 夜 歷 令 衣 衍 秋 糧 蟲 至 裝 收 娃 種 侯 播 熟 雨 耘 青 邑 
紀=念 律 錄 元 事 綱 年 行 委 要 實 檢 昀 政 
禮=拜 物 貌 教 堂 節 服 儀 品 法 讓 俗 數 金 帽 包 盒 炮 遇 券 贊 記 義 待 成 聘 賓 兵 部 畢 單 花 佛 器 制 治 冠 樂 泉 縣 
香=港 煙 味 氣 水 蕉 甜 爐 腸 燭 粉 花 片 火 油 料 客 灰 案 瓜 皂 薰 脆 車 吻 椿 菇 菜 會 澤 精 櫞 橙 干 茅 江 的 草 濃 山 脂 茶 閨 薷 囊 波 檳 醇 臭 肚 風 榧 ? 米 茗 蒲 型 蕈 艷 樟 袋 盒 河 凝 丸 液 魚 郁 妃 榭 
飛=機 來 跑 過 快 揚 舞 翔 馳 奔 躍 鳥 行 濺 騰 越 龍 漲 速 艇 蛾 禽 天 渡 輪 地 船 絮 度 拳 彈 泉 魚 白 往 到 車 的 起 抵 去 出 碟 燕 身 回 逝 向 走 鷹 蓬 轉 上 航 鏢 人 刀 入 進 離 瀑 雪 掠 靈 流 落 迸 播 步 蟲 掉 動 紅 鴻 架 跨 沫 盤 散 灑 升 鼠 駛 吻 旋 瀉 檐 眼 云 賊 災 舟 報 塵 狐 蝗 臨 鳴 球 射 石 
掙=扎 脫 開 斷 錢 到 揣 命 得 來 
仆=人 役 從 婦 
共=同 和 有 產 鳴 事 計 存 總 勉 處 管 敘 闖 生 謀 識 振 性 建 享 為 通 創 約 渡 進 度 舞 聚 賞 商 用 感 需 軸 稱 赴 犯 軛 餐 話 居 棲 慶 時 飲 贏 議 保 匪 工 價 軍 面 妻 析 線 養 浴 運 
謠=言 傳 諺 俗 風 
設=法 若 計 想 備 立 施 有 置 防 宴 疑 使 伏 定 的 于 在 成 限 為 下 色 點 或 崗 局 卡 攤 障 
圖=畫 書 案 章 樣 像 形 謀 表 說 片 譜 景 版 解 個 記 紙 釘 籍 式 騰 文 標 一 庫 為 中 二 上 例 利 鑒 集 示 冊 強 層 論 錄 板 報 讖 存 幻 卷 符 塊 名 位 元 
佩=服 刀 帶 劍 戴 特 玉 思 蘭 飾 
拒=絕 捕 收 不 付 賄 斥 敵 賠 聘 簽 載 留 
鋪=子 蓋 戶 張 板 面 位 展 陳 設 墊 裝 就 軌 平 路 排 滿 砌 地 開 保 床 襯 底 家 炕 攤 敘 成 好 
宗=教 旨 法 師 祠 派 室 廟 族 主 親 人 匠 譜 祧 兄 仰 
議=論 員 會 決 院 案 定 政 事 長 席 和 程 價 題 購 
買=賣 辦 主 進 肉 官 飯 春 成 卡 客 通 價 方 家 了 入 到 的 樓 下 書 回 來 些 菜 票 車 過 點 單 賬 給 斷 手 好 者 藥 房 醉 畫 空 米 去 走 
體=面 會 驗 貼 裁 力 諒 育 格 操 態 質 現 恤 統 系 制 溫 重 味 罰 積 例 察 魄 式 彩 檢 形 能 貌 液 內 壇 外 弱 認 悟 表 委 院 位 長 虛 改 念 療 測 詞 高 己 腔 衰 校 協 惜 癬 針 征 臭 節 覺 總 
溫=柔 和 暖 習 泉 情 度 馨 存 室 州 熱 飽 厚 順 課 網 書 水 床 帶 差 莎 文 馴 良 婉 潤 標 乎 服 居 覺 控 濕 湯 吞 暾 雯 煦 純 江 嶺 美 香 雅 
條=件 子 約 理 紋 款 陳 幅 凳 桌 例 目 案 文 規 石 貫 幾 播 令 列 數 碼 項 狀 絨 痕 鋼 塊 形 魚 
軍=隊 人 閥 官 事 服 警 衣 艦 民 火 裝 營 政 用 歌 部 士 樂 師 醫 帽 號 旗 械 需 法 界 備 委 機 馬 區 校 訓 情 心 車 禮 令 容 方 功 刀 籍 紀 國 曹 務 職 墾 糧 器 銜 餉 費 團 制 操 港 工 權 屬 鴿 力 旅 犬 中 售 演 風 齡 地 郵 長 列 綠 博 徽 婚 魂 管 規 購 階 控 品 棋 嫂 體 威 伍 援 種 轉 鼓 略 內 史 統 屯 資 
著=作 名 者 書 錄 稱 文 譯 合 迷 有 
車=子 夫 站 窗 輪 輛 門 間 廂 馬 錢 票 把 頭 身 隊 道 燈 轍 載 床 鈴 禍 棚 皮 下 貼 閘 流 庫 軸 長 胎 次 架 速 體 型 影 照 位 上 主 程 迷 廠 行 內 牌 費 手 資 尾 后 外 種 船 房 前 用 頂 場 底 臣 技 城 容 裂 標 幫 本 帶 匪 鉤 工 檢 駕 況 筐 貌 模 篷 圈 市 鎖 條 削 轅 長 組 刀 份 輻 杠 管 號 里 鏈 盤 旁 轄 座 
叫=做 喊 喚 好 賣 罵 囂 苦 嚷 車 人 價 作 聲 著 座 醒 的 出 到 板 住 停 來 法 起 床 春 道 號 魂 絕 勁 門 名 屈 嘯 響 冤 陣 子 錯 吠 回 牌 去 為 
受=到 傷 苦 罪 累 難 氣 刑 訓 罰 驚 害 騙 聽 益 命 賄 辱 涼 敵 挫 戒 降 電 案 聘 精 熱 災 寒 禮 領 事 托 獎 權 潮 理 惠 損 訪 壓 了 過 雇 此 阻 人 審 教 眾 助 限 用 著 洗 創 困 盡 孕 制 死 控 屈 虐 檢 病 寵 業 體 讓 粉 力 測 夠 冷 禪 旱 窘 盤 窮 賞 暑 胎 援 冤 閱 凍 
豐=富 滿 收 盛 厚 美 潤 產 年 碩 饒 盈 足 碑 裕 茂 田 胸 沛 順 乳 稔 登 歉 實 贍 臺 沃 腴 城 都 功 隆 南 寧 縣 原 
附=近 和 帶 錄 有 著 屬 加 耳 設 注 庸 中 小 件 言 筆 表 圖 上 送 在 頁 則 點 贈 議 生 會 身 逆 麗 白 后 睪 驥 記 寄 體 載 冊 款 隨 托 文 約 子 
觀=念 察 眾 點 音 看 賞 光 感 望 摩 禮 測 瞻 象 想 后 燈 戰 景 之 者 其 照 海 覽 潮 風 賽 審 止 棋 色 濤 
疑=心 惑 問 慮 團 難 點 義 云 案 陣 犯 是 為 兇 似 猜 竇 懼 忌 
鏡=子 頭 框 臺 匣 架 片 中 面 屏 像 箱 邊 里 筒 
停=止 刊 下 頓 留 泊 車 滯 工 當 戰 辦 靠 課 歇 放 息 業 火 電 職 產 水 牌 在 了 售 賽 用 飛 建 機 住 步 播 駛 學 付 發 手 擺 點 靈 閉 表 航 緩 供 氣 食 妥 薪 訓 勻 診 經 尸 一 駐 
維=持 護 系 修 科 柯 基 族 生 新 度 和 權 綸 文 語 納 西 希 
程=度 序 式 控 
傳=統 說 奇 達 播 記 單 染 出 授 遞 聞 教 言 誦 話 世 令 揚 代 喚 習 送 閱 種 人 導 呼 你 抄 情 唱 票 熱 頌 訊 真 媒 道 來 輸 給 到 入 動 承 譯 遍 信 神 中 開 銷 球 為 回 下 上 過 布 電 書 述 看 感 本 流 略 燈 粉 觀 告 經 家 見 戒 名 續 檄 寫 藝 語 旨 贊 標 審 位 問 謠 質 
冬=天 季 瓜 至 青 衣 筍 眠 夏 景 春 菜 菇 防 日 麥 閑 訓 令 泳 煉 儲 初 烘 寒 節 末 運 月 貯 裝 風 夜 蔥 梅 雪 汛 雨 
孔=子 雀 廟 泉 丘 隙 穴 洞 府 明 型 教 孟 融 林 道 伋 徑 氏 眼 ? 德 口 
星=期 光 辰 子 球 斗 宿 云 火 空 夜 河 相 象 座 緣 體 團 際 系 號 級 洲 馬 月 探 圖 占 形 等 蟲 漢 晴 散 術 愿 馳 海 盤 群 狀 
通=過 俗 譯 知 信 訊 紅 常 行 電 融 順 用 稱 緝 宵 報 商 告 明 向 往 達 篇 病 令 衢 人 曉 車 盤 道 例 身 暢 風 亮 草 敵 路 婚 史 則 話 論 性 才 讀 氣 天 神 鑒 寶 條 航 郵 牒 書 共 國 假 貨 欄 式 脹 的 查 識 關 縮 夜 透 奸 靈 量 覽 到 上 力 海 便 經 化 分 連 聯 年 遼 吃 徹 誠 兌 好 匪 觀 家 解 名 鋪 票 竅 勤 宿 體 途 同 脫 縣 產 帶 河 江 考 水 許 迅 榆 約 
杭=州 紡 錦 
團=體 結 圓 聚 員 里 扇 轉 部 伙 拜 練 子 隊 粉 日 委 契 費 年 齡 長 粒 弄 丁 徽 副 購 氿 籍 課 旗 臍 校 音 魚 章 坐 職 服 級 塊 身 藻 
攻=擊 打 破 勢 陷 讀 占 克 進 關 守 堅 略 入 防 絲 取 下 城 訐 伐 擂 博 搏 錯 殲 球 心 來 
稱=為 呼 贊 心 號 作 道 頌 職 身 許 雄 譽 快 謂 謝 霸 之 他 說 王 美 做 是 帝 奇 述 冠 量 病 便 兵 臣 大 貸 賀 好 賞 體 嘆 羨 意 愿 揚 引 慶 觴 出 多 其 
都=會 市 督 城 是 有 要 能 在 可 很 不 好 說 以 想 得 沒 將 比 來 受 去 還 愛 使 到 行 怪 會 強 道 昌 靈 統 未 尉 邑 勻 
資=格 料 本 產 助 源 金 方 財 望 質 歷 力 深 信 訊 政 費 材 借 陽 中 
千=萬 秋 金 斤 歲 夫 日 龍 次 帖 樓 張 瓦 禧 年 人 元 里 個 百 克 古 位 米 種 噸 字 載 伏 山 周 倍 家 赫 卡 萬 升 兆 
評=論 價 書 語 劇 判 議 定 斷 獎 戲 理 為 委 選 傳 介 分 注 彈 話 理 說 比 功 估 審 核 級 析 述 改 出 聘 測 點 卷 薦 薪 星 優 閱 騭 工 
警=察 告 報 惕 句 戒 官 覺 備 笛 衛 醒 犬 士 棍 鐘 車 匪 語 界 方 員 隊 署 務 司 區 訊 力 局 號 民 示 校 世 探 鈴 容 齡 長 燈 督 服 徽 風 花 紀 嫂 亭 銜 械 用 種 標 槍 
制=度 造 服 作 裁 止 定 版 約 訂 伏 圖 為 發 出 品 備 式 鹽 劑 的 成 衣 藥 衡 動 法 程 片 冷 勝 革 毒 做 憲 表 導 粉 黃 件 假 景 帽 錢 售 糖 取 鞋 
否=則 認 定 決 乎 
夜=里 晚 間 色 飯 鶯 車 壺 景 叉 校 工 班 空 幕 游 市 宵 餐 大 月 巡 郎 魔 戰 場 宿 鷹 的 半 深 光 行 勤 來 闌 蛾 奔 話 航 禁 課 盲 曲 談 霧 襲 宴 作 長 禱 燈 分 風 警 
爺=兒 娘 們 
激=動 烈 起 昂 發 情 勵 蕩 流 進 怒 憤 戰 浪 增 光 切 活 素 化 辯 賞 靈 變 磁 奮 將 劇 越 揚 波 斗 濺 子 
掌=柜 握 聲 故 管 心 舵 權 班 擊 勺 上 控 門 鞭 廚 燈 骨 紋 印 嘴 灶 子 狀 
姨=媽 母 娘 兒 婆 表 夫 丈 妹 
洋=人 車 服 錢 房 溢 貨 行 火 布 裝 灰 氣 鐵 奴 務 紗 財 槐 瓷 油 緞 相 蔥 井 菜 堿 粉 鎬 流 芋 酒 麻 樓 紅 場 化 葷 姜 面 盤 炮 派 槍 式 文 煙 罪 兵 裁 參 底 蘭 浦 傘 水 縣 銀 
例=如 外 子 證 言 假 句 題 行 會 規 禁 解 程 示 文 
靜=寂 默 聽 坐 穆 止 養 物 水 立 脈 態 的 電 待 心 候 香 觀 音 色 夜 安 謐 鞭 場 海 僻 園 岡 地 樂 如 思 臥 壓 宜 
壓=迫 倒 制 抑 力 低 榨 服 縮 驚 斷 上 境 痛 軸 的 下 住 陣 蓋 紋 碎 鑄 印 平 過 扁 電 裂 板 秤 產 場 船 車 頂 錠 隊 貨 根 價 擠 垮 庫 強 氣 青 歲 臺 條 線 邪 載 出 光 痕 花 壞 簧 降 緊 破 頭 彎 延 枝 
熟=悉 人 識 練 睡 透 知 食 客 路 地 手 女 手 語 字 菜 鐵 土 的 習 絡 了 讀 稔 諳 年 料 慮 道 化 荒 記 漆 思 燙 飯 皮 視 
伺=候 機 服 隙 奉 服 
萬=一 分 歲 千 物 事 惡 能 年 難 福 望 木 宇 樓 帖 元 人 名 個 里 國 象 維 民 有 噸 貫 戶 眾 不 方 余 變 家 字 用 世 全 古 壽 金 丈 卷 寶 臺 次 代 般 種 縷 幸 隆 兩 鈞 山 歷 寧 俟 籟 端 機 頃 乘 死 歲 縣 狀 圭 乘 道 類 馬 米 畝 榮 向 億 源 重 
會=議 兒 員 上 場 見 面 刊 務 意 計 心 同 演 談 后 晤 費 客 合 話 章 考 友 堂 審 聚 前 試 商 戰 址 期 厭 黨 診 餐 師 陰 操 徽 旗 在 有 的 否 被 將 把 和 所 使 中 用 很 受 通 讓 要 說 去 好 做 展 眾 訊 下 社 來 首 報 籍 當 理 里 聽 死 館 贏 飛 不 管 玩 干 唱 車 風 海 標 鈔 典 攻 剿 門 盟 簽 齊 水 頭 銜 元 長 賬 子 昌 拜 地 東 澤 醉 
長=大 久 期 篇 安 江 衫 輩 沙 袍 城 處 官 嘆 短 年 途 者 子 廊 街 壽 遠 發 工 進 孫 椅 凳 老 征 相 空 河 上 春 度 褲 矛 假 眠 存 槍 齋 劍 跑 寧 寬 出 棍 杖 親 隨 活 嶺 笛 局 足 蟲 勢 物 纓 的 達 線 青 了 約 于 談 袖 腿 裙 榮 崎 程 夜 虹 毛 生 形 命 條 流 龍 樂 庚 方 的 信 住 號 風 靴 襪 驅 清 句 詞 大 年 臉 別 膘 城 川 刀 話 法 房 骨 鼓 跪 焦 卷 鋏 機 腳 考 款 鳴 門 拳 舌 逝 詩 天 亭 項 休 性 嘯 銷 行 效 兄 影 圓 幼 眼 女 成 得 臂 辮 打 帶 島 點 釘 隊 肥 豐 高 葛 故 海 紅 靠 列 瘤 滿 明 男 胖 皮 繩 順 泰 汀 武 些 興 須 芽 牙 言 陽 衣 音 吟 有 垣 在 枕 治 
默=認 契 許 哀 寫 讀 想 書 然 禱 劇 念 地 察 記 片 誦 算 坐 從 示 
婚=姻 禮 事 約 書 期 配 嫁 內 戀 紗 外 前 后 宴 變 否 檢 齡 典 媾 假 介 慶 娶 俗 史 喪 育 照 
站=住 立 臺 崗 穩 隊 直 街 牌 票 在 內 著 有 起 務 主 點 到 開 位 前 定 到 哨 相 長 過 滿 名 姿 
帝=王 國 君 位 號 京 都 
死=去 亡 人 者 尸 刑 鬼 活 傷 命 地 板 守 神 罪 路 水 灰 力 囚 難 因 理 戰 敵 物 訊 記 法 盯 背 絕 抱 拼 豬 信 結 癥 硬 仗 沉 黨 角 胎 的 了 于 后 在 不 啦 前 心 掉 氣 海 生 寂 纏 別 相 定 鎖 要 機 光 牢 產 等 點 緩 耗 犯 谷 局 節 扣 滅 錢 棋 期 契 性 靈 球 區 巷 
復=雜 仇 活 興 古 辟 旦 制 原 員 刊 信 發 述 合 蘇 印 寫 調 件 習 查 舊 試 議 函 審 數 診 核 姓 比 句 利 種 出 式 牌 本 元 市 生 工 職 歸 賽 會 電 明 業 得 國 建 位 盤 聰 讀 方 婚 航 返 崗 果 關 交 檢 課 墾 命 萌 談 通 線 學 選 現 葉 眼 音 圓 轉 壯 擺 測 來 燃 誦 算 校 性 
箱=子 籠 底 包 根 體 內 
部=分 隊 門 下 落 位 屬 署 件 類 首 將 委 族 曲 級 長 頒 頭 優 標 獎 
紳=士 耆 商 
演=員 說 出 講 義 唱 奏 習 技 變 進 化 繹 算 藝 示 戲 練 播 劇 武 壇 
鐘=頭 聲 點 樓 表 擺 愛 鼓 馗 情 山 離 鼎 靈 面 琴 塔 祥 響 
廣=告 大 東 州 場 播 泛 闊 西 義 博 貨 柑 收 辟 度 受 為 島 電 安 源 廈 角 納 南 域 德 交 開 袤 漠 宣 繡 元 遠 宇 陵 漢 靈 寧 平 饒 水 
良=心 好 友 善 民 知 田 醫 方 師 藥 夜 母 馬 種 宵 策 機 性 多 久 緣 朋 人 辰 材 港 家 將 苦 言 駒 吏 態 莠 
選=擇 集 舉 出 定 本 取 用 中 拔 手 購 修 材 錄 框 誰 題 種 派 民 票 送 聘 項 為 區 單 了 址 讀 美 輯 戰 配 自 曲 入 段 好 任 編 課 料 萃 文 詞 留 報 場 調 登 點 件 刊 礦 收 型 育 樣 優 字 粹 號 煤 品 去 系 
抵=抗 制 押 御 擋 達 觸 消 償 賴 住 罪 港 銷 死 債 扣 臨 補 還 換 交 繳 近 命 免 數 事 牾 用 賬 埠 充 京 拒 
白=話 天 色 布 紙 云 日 費 發 眼 人 面 菜 馬 薯 水 晝 地 凈 楊 糖 沫 旗 玉 米 銅 癡 鴿 鷺 兔 骨 金 酒 樺 銀 字 鶴 露 灰 藥 點 卷 描 熱 飯 果 搭 帶 丁 蠟 事 鐵 領 喉 梨 熊 璧 霧 貓 喝 來 皮 拿 說 文 藤 條 案 礬 區 鷴 族 宮 體 匪 芍 食 湯 質 的 石 雪 了 沙 田 頭 蘭 衣 城 虎 羊 板 光 粉 熾 蛋 毛 蟻 皙 底 粥 蓮 鱔 龍 蛇 術 嘍 嫩 饒 鰱 堊 蘞 磷 蛉 刃 肉 潤 靈 鵝 臉 練 班 榜 版 醭 斑 吃 醋 碴 茬 茶 瓷 道 ? 化 干 鸛 給 及 劇 芨 口 茅 煤 票 胖 判 手 首 陶 廳 薇 相 ? 翳 煙 災 楂 雉 芷 種 寫 邊 冰 打 帝 俄 帆 活 鯨 菊 軍 盔 浪 令 鹿 忙 棋 紗 山 衫 鼠 霜 送 塔 檀 須 癬 揚 洋 頁 夜 用 羽 煮 濁 做 鼬 
處=理 置 所 于 女 在 境 世 分 罰 死 決 士 事 治 方 警 刑 以 之 身 男 級 暑 子 長 均 
把=頭 手 握 戲 門 式 柄 持 兒 守 關 它 他 我 你 她 人 那 酒 錢 玩 風 脈 住 弄 攬 牢 舵 穩 兄 盞 捉 好 桶 
冷=笑 靜 淡 落 酷 汗 水 氣 眼 風 清 漠 箭 僻 戰 暖 熱 天 卻 光 寂 藏 峭 遇 葷 凍 門 盤 雨 對 冰 視 食 飲 布 宮 槍 縮 菜 餐 場 貨 庫 凝 泉 的 血 軋 了 焊 得 鋒 面 傲 厲 床 嘲 鐓 丁 點 諷 敷 害 話 飯 柜 峻 噤 澀 色 杉 霜 燙 艷 語 硬 字 臉 待 動 浸 夏 鑄 
擔=心 任 子 負 保 當 架 待 面 憂 綱 驚 名 水 
巴=金 黎 結 掌 望 西 特 蒂 薩 豆 士 人 赫 以 林 哈 頓 喬 烏 東 克 庫 厘 山 彥 中 
堅=決 持 強 定 固 實 硬 守 信 韌 毅 牢 冰 貞 苦 稱 挺 忍 壁 果 厚 勁 
茶=房 館 杯 葉 壺 幾 碗 水 會 座 點 花 樓 盤 具 錢 飯 社 匙 湯 缸 亭 色 托 鹵 食 油 碟 樹 園 晶 爐 農 場 磚 坊 藝 道 室 客 莊 吧 炊 垢 酒 鏡 堿 品 青 肆 攤  桌 罐 話 陵 山 
做=事 出 到 人 夢 官 好 成 工 飯 法 主 活 詩 賊 題 空 掉 種 甚 功 操 了 得 個 過 些 起 錯 完 大 愛 就 多 點 戲 對 小 作 著 假 菜 上 強 臉 伴 東 鬼 局 客 媒 派 親 壽 莊 夢 
用=處 力 意 人 心 功 以 盡 于 作 語 途 勁 品 具 法 費 兵 場 度 事 武 戶 項 的 來 電 了 者 地 手 在 上 水 之 此 得 料 時 到 量 過 為 完 詞 膳 它 藥 字 紙 刀 書 錢 筆 車 油 火 餐 工 好 回 去 腦 光 舊 色 錯 計 房 情 著 做 活 點 足 例 茶 典 飯 煤 命 刑 印 不 掉 壞 誰 友 
恢=復 弘 廓 
蘇=聯 州 子 醒 打 區 中 式 秦 超 木 丹 繡 鐵 浙 軾 方 珊 杭 俄 美 芮 白 共 瑾 軍 劇 廷 ? 武 轍 榮 克 北 堤 南 童 瓦 制 
技=巧 術 藝 能 師 工 法 校 改 擊 嘉 癢 
委=屈 員 實 托 婉 曲 任 派 辦 會 身 以 頓 培 瑣 蛇 
游=戲 行 記 人 玩 覽 泳 客 歷 廊 離 蕩 子 民 擊 俠 艇 伴 說 逛 絲 興 牧 船 樂 動 刃 龍 弋 資 士 水 學 蹤 藝 園 街 走 憩 魂 去 來 獵 標 程 春 方 舫 禽 鄉 移 勇 醫 轉 者 過 進 輪 隙 魚 
副=刊 官 手 業 題 本 詞 總 署 修 理 根 品 歌 虹 攻 將 科 券 食 項 研 處 職 井 王 線 翼 證 軸 
宇=宙 航 內 瞻 文 
訪=問 友 求 客 港 華 美 談 日 古 查 舊 尋 員 
講=究 話 演 義 臺 堂 師 學 述 和 解 授 求 稿 課 座 情 壇 法 著 評 到 道 得 過 出 起 好 明 給 理 價 經 習 論 古 清 史 說 談 敘 桌 定 讀 書 武 席 
肩=膀 頭 胛 負 章 窩 上 并 帶 背 挑 角 扛 
缺=少 乏 點 陷 欠 憾 口 德 席 課 額 門 勤 的 陣 失 氧 水 貨 編 損 漏 人 略 電 刻 省 位 員 頁 字 嘴 鐵 血 油 
敷=衍 藥 設 料 陳 貼 
考=慮 試 察 證 據 驗 究 上 生 取 官 場 核 卷 綱 號 校 績 期 分 勤 題 量 古 完 入 查 到 過 前 中 博 妣 點 訂 風 工 紀 級 寄 評 聘 區 求 釋 問 學 研 語 種 
風=格 箏 景 氣 俗 潮 雨 流 度 聲 味 光 暴 波 雅 水 頭 雪 月 化 塵 情 浪 云 沙 物 行 韻 車 琴 寒 險 采 霜 姿 聞 騷 尚 箱 帆 骨 雷 向 范 扇 致 干 涼 帽 色 勢 神 燈 紀 貌 靡 土 帶 華 儀 鏡 習 煙 力 火 兒 碼 衣 傳 口 鈴 操 磨 能 擋 笛 洞 圈 速 癱 壓 鉆 吹 趣 中 濕 災 生 起 里 管 鳥 爐 ? 道 電 斗 發 害 耗 戽 級 門 婆 蝕 謠 源 疹 障 急 絮 驟 標 城 冷 輪 選 
保=護 持 存 留 衛 守 佑 證 障 險 全 重 管 定 安 姆 養 鏢 甲 密 人 釋 薦 藏 送 駕 舉 暖 家 函 溫 單 健 羅 費 育 住 濕 本 額 有 值 鮮 用 稅 命 底 質 修 金 量 廉 膘 堤 皇 換 固 潔 價 結 級 假 媒 苗 期 山 墑 收 胎 息 準 長 真 狀 組 爾 戶 靖 身 
畫=家 像 面 報 圖 片 眉 院 幅 法 冊 師 展 筆 舫 譜 具 布 軸 工 卷 室 帖 稿 屏 船 刊 架 境 意 外 滿 廊 板 匠 壇 紙 皮 頁 出 上 集 作 中 質 會 得 風 成 下 好 餅 本 到 粉 符 功 供 夾 圈 貼 押 苑 知 字 虎 堂 兒 框 里 論 謎 完 王 線 圓 中 
巡=警 捕 邏 撫 視 禮 回 游 行 查 更 防 夜 航 診 察 道 風 檢 哨 守 天 幸 演 弋 展 邊 官 
山=東 水 西 坡 頂 頭 路 川 林 腳 谷 洞 峰 河 羊 城 村 莊 腰 色 溝 區 歌 道 嶺 門 野 民 地 洪 口 巒 坳  茶 澗 脈 泉 麓 芋 楂 崩 貨 崖 陵 峽 勢 岳 藥 岡 寨 丹 脊 梁 巖 青 姆 盟 炮 鄉 包 草 窩 桃 雞 險 國 轎 貓 雀 塢 系 的 上 中 景 下 大 火 邊 鷹 人 石 南 徑 海 丘 間 居 楊 形 崎 高 風 崗 神 嵐 巔 壑 呼 腹 根 果 鬼 積 侃 塘 洼 響 子 嘴 珍 鵲 前 凹 胞 壁 狗 花 甲 里 木 鳥 體 田 外 溪 陽 陰 月 賊 志 鷸 
友=誼 情 人 好 愛 邦 軍 協 鄰 善 聯 生 朋 
動=作 物 手 人 身 搖 靜 筆 機 不 力 心 亂 氣 彈 員 蕩 向 聽 詞 態 武 用 工 情 怒 火 土 手 脈 刀 議 產 的 畫 感 輒 能 容 腦 粗 輪 量 因 兵 腳 嘴 換 口 漫 遷 窩 問 刑 一 嘴 真 賓 腳 覺 
使=得 用 勁 命 者 館 喚 女 節 壞 徒 團 我 人 他 其 你 之 它 她 出 您 然 成 氣 臣 假 性 君 聾 跑 痛 役 載 皺 
權=利 力 威 勢 限 術 柄 貴 衡 益 門 謀 且 位 傾 能 屬 責 為 作 重 證 當 詐 宜 時 要 數 略 變 標 臣 炒 輿 重 杖 錢 
服=務 裝 從 侍 氣 飾 藥 役 用 毒 輸 帖 刑 食 了 膺 下 人 軟 老 辯 滿 喪 色 式 罪 法 
水=手 面 車 果 平 邊 仙 庫 泥 晶 流 壺 桶 珠 準 災 溝 門 池 銀 缸 花 路 洗 泡 利 兵 火 田 牛 草 師 煙 鳥 地 紅 道 榭 波 陸 族 分 氣 塘 筆 深 土 性 藻 旱 渠 勢 鄉 管 磨 滴 電 生 源 粉 坑 龍 產 井 塔 獺 患 母 星 閘 彩 程 酒 力 瓢 汽 渦 壩 解 能 蛇  印 蔥 貂 碓 量 牌 頭 溫 線 戰 柱 稻 餃 界 警 雷 碾 圈 位 澤 竹 肥 工 化 萍 螅 險 箱 袖 壓 質 腫 灣 的 瓶 務 中 浸 上 域 貨 運 底 廠 費 冷 里 墨 泵 煮 下 系 淹 口 滸 療 文 球 喝 聲 泉 鴨 樣 選 情 害 痘 禽 體 色 槽 王 帖 暖 靈 鹿 綠 落 輪 簾 澇 牢 表 濱 標 城 層 床 尺 錘 ? 遁 荒 合 鶴 華 閥 發 法 感 垢 臌 罐 怪 軍 堿 景 窖 具 劑 漿 皰 區 槍 橇 神 杉 筲 蝕 汀 潭 網 霧 紋 洼 秀 瀉 靴 眼 鉆 葬 蛭 光 岱 笙 霸 部 斗 封 富 閣 鬼 際 價 精 孔 密 沫 盆 芹 虱 團 堰 楊 揚 芋 浴 云 蚤 寨 注 漬 蠆 
黃=昏 色 河 土 金 花 沙 山 種 油 酒 豆 牛 瓜 魚 鳥 銅 連 羊 鶯 海 蜂 泉 楊 鸝 鱔 鼬 毛 黑 碟 燈 了 暈 河 道 醬 麻 疸 磷 米 壤 埔 頁 玉 龍 的 石 帝 柏 光 梅 教 斑 牌 葉 巾 白 鶴 蓮 素 皮 南 櫨 磊 榜 檗 茶 菜 毒 蓋 覺 片 芩 ? 雀 書 熟 鼠 湯 糖 檀 癬 毅 煙 奕 閱 源 鉆 賬 霑 征 蓉 安 村 岡 化 姜 陵 綠 平 坡 浦 橋 砂 酮 緯 巖 易 樟 州 驊 
姊=妹 
雙=手 方 喜 臂 目 親 重 料 星 鉤 眸 掌 休 雄 塔 屏 絕 解 機 管 缸 側 核 響 簧 拐 日 聲 幅 杠 軌 邊 眼 語 腳 人 向 贏 倍 面 程 層 腿 線 子 魚 打 周 色 頻 筒 城 糖 膝 唇 耳 月 翼 股 晶 片 相 飛 鳳 頰 生 十 擊 數 亡 龍 胞 刃 擁 肩 眉 座 拼 刀 份 炸 鬢 翅 號 關 工 滘 基 鍵 全 搶 棲 薪 縐 靨 浴 百 鞭 峰 湖 劍 江 節 流 輪 盲 牌 槍 乳 行 姓 修 陽 音 優 
橘=子 柑 色 絡 紅 黃 樹 
造=成 反 謠 就 化 物 作 船 福 詣 型 紙 林 價 出 勢 訪 假 形 字 像 句 血 影 孽 表 次 冊 材 端 飯 田 磚 幣 詞 橋 園 渣 
呆=子 板 滯 笨 久 傻 在 立 住 坐 著 愣 氣 賬 站 料 人 頭 
每=逢 當 盤 出 年 個 一 日 月 天 次 位 人 股 周 項 張 間 晚 班 兩 隔 頁 組 場 份 宗 件 期 季 秒 層 節 到 種 部 套 條 只 隊 戶 分 家 篇 課 輛 屆 時 樣 幅 百 塊 句 餐 支 冊 夜 筆 箱 臺 局 米 回 噸 斤 畝 桶 行 
具=有 體 備 名 像 結 象 文 保 
淡=漠 紅 然 雅 化 忘 水 妝 月 抹 靜 出 的 季 薄 黃 定 泊 市 菜 色 綠 入 藍 灰 墨 青 酒 去 紫 
驕=傲 陽 氣 矜 橫 慢 人 狂 子 躁 縱 
秀=才 麗 氣 美 雅 媚 眉 林 真 發 慧 色 峰 潤 俊 挺 逸 山 
合=適 作 理 乎 刊 成 同 唱 法 一 并 算 宜 伙 力 群 用 辦 攏 拍 奏 格 轍 計 流 身 著 肥 璧 演 影 抱 歡 股 資 共 夥 訂 集 卡 服 圍 營 金 龍 署 約 照 組 符 著 起 時 編 于 體 情 稱 掌 心 住 意 建 會 家 式 謀 度 該 擊 劑 腳 口 十 數 手 眼 頁 葉 議 葬 子 閘 板 川 調 江 取 山 校 陽 音 鑄 租 
矛=盾 頭 尖 
師=長 傅 范 兄 爺 母 生 父 部 友 姐 哥 弟 妹 徒 法 團 娘 伯 資 承 公 大 說 事 表 院 專 恩 傳 門 旅 德 訓 職 從 姑 級 叔 尊 
恰=好 當 巧 如 似 切 離 逢 有 遇 
檢=查 討 點 閱 舉 察 驗 場 疫 視 控 索 測 獲 定 修 核 錄 漏 波 票 束 審 字 出 錯 
眉=毛 頭 目 眼 梢 宇 心 峰 批 睫 臉 棱 筆 端 題 尖 佳 山 縣 形 
歌=聲 唱 曲 頌 舞 劇 詞 謠 詠 手 喉 子 星 訣 廳 友 碟 會 譜 本 壇 迷 名 集 德 王 者 女 藝 賦 兒 帶 后 妓 姬 伎 神 吟 路 
包=括 圍 袱 含 子 裹 辦 廂 扎 車 頭 飯 谷 涵 裝 公 庇 票 管 容 攬 皮 抄 干 拯 下 教 夜 工 探 租 圓 金 修 銷 羅 機 你 產 著 賠 在 好 上 住 起 保 了 藏 年 間 米 月 囊 兒 場 單 房 費 伙 換 鋼 舉 價 片 退 席 養 銀 孕 蘊 衣 桌 層 船 封 縫 給 里 絡 膜 去 身 箱 
喝=酒 彩 令 足 上 多 了 水 道 的 茶 下 醉 杯 得 著 完 罵 過 到 斥 問 粥 干 夠 光 湯 叱 
范=圍 疇 本 例 文 式 且 家 縣 
象=征 是 牙 形 棋 限 山 鼻 湖 馬 人 
深=刻 入 處 夜 知 厚 沉 思 信 切 淵 山 情 藍 淺 奧 度 意 遠 秋 閨 究 受 廣 色 造 邃 重 谷 透 圳 灰 黃 宮 大 交 耕 化 井 水 的 感 表 愛 層 海 得 為 藏 陷 有 長 諳 怕 坑 紫 潭 紅 綠 恐 槽 冬 翻 壑 股 澗 青 澀 地 通 談 望 省 巷 幽 憂 摯 湛 院 仇 溝 痕 慮 埋 市 痛 挖 蘊 證 
署=名 理 長 
吩=咐 
句=子 法 號 式 型 話 中 柄 點 讀 讀 踐 群 
布=置 景 滿 告 鞋 衣 爾 匹 局 丁 帛 面 防 紋 衫 邊 歐 頭 雷 傘 料 設 道 朗 施 袋 店 條 線 偶 陣 下 什 菜 點 谷 警 控 幔 票 網 藝 展 帶 簾 篷 片 裙 商 拖 
漢=奸 子 口 族 人 文 字 語 學 中 城 民 魏 詩 堂 姓 劇 英 堡 代 譯 墓 化 朝 書 陽 唐 賦 皋 卡 水 托 川 方 沽 江 隸 滿 姆 儒 壽 王 陰 源 
憤=怒 慨 激 然 恨 懣 青 
逐=漸 一 步 日 個 句 次 年 臭 級 出 項 條 月 鹿 字 層 行 點 退 
減=少 輕 價 低 色 退 肥 弱 法 讓 縮 刑 號 慢 免 壓 速 至 息 薪 稅 半 幅 產 去 緩 收 持 到 小 損 除 的 租 值 人 掉 倉 負 虧 數 削 員 震 災 征 食 
莊=嚴 子 稼 重 家 周 股 園 員 戶 主 田 院 河 票 
舍=得 棄 身 命 人 親 己 監 利 去 臉 入 賓 掉 弟 間 下 友 
玫=瑰 
模=糊 樣 范 仿 型 擬 子 式 特 組 板 本 塊 具 鍛 件 棱 數 效 壓 版 塑 態 制 
舞=臺 蹈 女 場 廳 動 弊 伴 曲 姿 步 劇 會 劍 池 技 獅 星 者 龍 娘 藝 鞋 弄 客 迷 譜 壇 美 男 陽 
徹=底 夜 查 骨 悟 
短=篇 文 促 發 處 褲 評 工 期 見 暫 命 裙 句 打 裝 少 粗 笛 路 棒 劍 途 語 波 跑 槍 淺 缺 訊 的 片 線 視 小 程 詩 劇 棍 繩 的 襪 信 秤 傳 長 刀 號 款 欠 壽 衫 腿 效 訓 池 歌 簡 鋸 索 尾 音 
丫=頭 的 杈 環 髻 枝 
驚=訝 異 奇 人 醒 喜 動 嘆 慌 詫 叫 險 呼 嚇 擾 懼 魂 蟄 出 羨 覺 天 恐 心 夢 起 愕 世 跑 聞 艷 駭 雷 怖 呆 鴻 風 怪 厥 悸 馬 悚 濤 悉 疑 蜇 避 跳 退 愣 
集=中 會 子 體 團 合 權 郵 聚 資 結 市 刊 鎮 訓 成 齊 錦 水 貿 散 約 群 裝 錄 日 納 部 材 藏 萃 解 句 居 釋 束 運 注 落 寧 賢 
細=心 致 膩 節 小 雨 長 微 碎 胞 菌 軟 毛 密 嫩 高 瓷 巧 潤 工 活 葉 肉 加 黑 處 弱 部 辛 則 布 發 目 作 別 紗 的 分 路 看 說 佬 讀 想 糧 數 語 聲 聽 察 沙 粒 問 述 觀 菜 點 化 紡 故 究 描 情 砂 瑣 挑 條 談 線 腰 鹽 賬 查 帶 粉 管 嚼 孔 礫 流 片 繩 瘦 絲 算 索 紋 咬 針 枝 
異=常 樣 性 國 議 鄉 族 端 域 地 己 彩 類 趣 香 狀 同 化 才 味 想 物 言 獸 能 心 讀 動 于 體 教 形 名 母 步 質 邦 人 日 詞 黨 乎 父 構 界 俠 型 姓 文 音 
閑=話 談 事 人 書 氣 扯 散 居 心 逛 錢 聊 章 蕩 置 得 職 情 時 暇 空 著 適 筆 步 愁 房 靜 季 篇 庭 田 逸 員 游 言 雜 渡 混 云 坐 
隊=伍 員 日 部 歌 形 列 禮 旗 友 副 徽 醫 長 別 服 
標=準 語 點 題 本 志 榜 致 明 記 簽 金 識 價 注 號 下 間 段 尺 兵 格 桿 燈 竿 書 示 有 的 貼 舉 圖 引 出 槍 上 量 稱 底 定 調 徽 高 賣 牌 石 線 度 繪 疽 名 統 王 
牧=師 童 場 人 羊 歌 民 馬 主 草 女 區 業 畜 放 戶 工 歸 犬 群 村 笛 郎 
申=報 斥 訴 請 明 說 辯 述 論 告 領 辦 奧 購 批 冤 令 飭 時 討 屠 雪 謝 城 曲 扎 
西=方 山 裝 北 邊 南 瓜 服 醫 安 風 式 面 歐 餐 頭 學 施 天 部 文 藥 畫 亞 點 端 皮 經 非 化 樂 岳 陸 歸 段 東 里 貢 宮 區 洋 岸 沙 湖 行 路 門 域 漢 寧 褲 城 游 德 周 海 進 江 夏 晉 關 蒙 郊 征 側 線 歷 陵 昌 菜 法 氿 虢 甲 ? 口 曬 魏 廂 元 語 藏 子 去 充 村 單 豐 和 華 吉 京 平 戎 四 峽 鄉 苑 站 
灰=色 心 白 塵 土 燼 沙 鼠 鶴 紅 頂 質 暗 的 黑 度 冷 泥 領 菜 分 垢 膏 光 漿 棚 市 肥 狗 化 黃 鯨 狼 霧 
右=手 邊 派 臂 傾 面 翼 耳 擊 拐 半 衛 鍵 腳 方 圖 上 下 的 轉 側 眼 路 腿 腦 肋 首 舷 端 行 旋 移 
信=仰 任 心 封 紙 箋 件 念 托 賴 徒 用 號 息 教 步 奉 服 義 函 札 手 條 女 士 箱 使 差 譽 達 守 物 史 風 德 道 貸 報 中 眾 實 佛 到 邪 從 訪 不 筆 度 匯 鴿 據 口 皮 石 宿 筒 望 陽 意 友 標 豐 管 文 宜 源 
效=果 力 用 率 勞 法 驗 應 能 仿 益 命 忠 顰 死 尤 
及=至 其 時 格 早 第 此 物 于 門 齡 冠 耳 
舉=行 人 動 起 止 手 辦 例 杯 措 過 重 報 出 目 世 凡 證 家 債 步 國 兵 要 著 哀 發 火 薦 借 事 槍 
舅=父 母 爺 媽 姑 嫂 子 
誤=會 解 事 國 傷 用 字 傳 點 讀 區 車 導 差 殺 判 認 入 了 信 餐 場 述 寫 食 人 工 碼 期 刪 時 診 報 稱 放 聽 譯 置 
寶=貝 貴 玉 石 物 藏 座 珠 劍 塔 地 庫 島 刀 號 蓋 雞 馬 林 安 兒 鋼 山 典 豐 箱 藍 盆 剎 殿 盒 卷 眷 書 玩 樹 狐 潔 清 興 應 
伙=計 食 伴 夫 房 同 犯 耕 子 種 
幻=想 象 滅 影 覺 景 境 異 成 術 燈 化 聽 城 夢 視 像 
遲=疑 早 到 鈍 緩 延 滯 了 來 的 暮 誤 慢 睡 
詳=細 盡 情 密 談 明 述 見 加 解 略 備 圖 悉 查 察 論 注 
病=人 房 態 倒 榻 菌 痛 癥 情 根 床 勢 狀 容 逝 源 故 危 夫 況 毒 假 魔 愈 友 理 象 例 因 原 殘 家 歷 休 征 變 號 史 退 員 灶 的 患 了 中 得 死 后 學 苦 弱 程 案 篤 害 候 句 區 室 體 院 疫 重 株 蟲 好 粒 
盼=望 著 顧 頭 到 歸 來 
獲=得 取 獎 釋 勝 益 悉 準 救 選 贈 利 知 致 罪 許 嘉 鹿 
浙=江 大 東 贛 西 
碼=頭 子 字 率 本 式 數 表 垛 放 洋 長 尺 元 
沖=突 動 鋒 破 擊 淡 洗 撞 開 殺 刷 這 在 刺 垮 積 浪 出 繩 印 入 天 涼 走 勁 上 向 程 過 進 著 力 線 昏 激 去 量 床 茶 掉 抵 頂 犯 毀 服 高 劑 決 擴 騰 田 塌 喜 銷 飲 澡 賬 子 曹 壞 孔 來 散 蝕 
忍=耐 受 心 讓 冬 痛 著 者 住 辱 了 
銀=屏 行 子 幕 錢 元 色 白 光 河 灰 匠 洋 幣 兩 號 耳 杯 根 牌 杏 錠 票 證 月 槍 聯 環 鼠 魚 川 發 狐 礦 朱 獎 座 線 器 團 的 樺 彈 針 南 樓 鈴 亮 鯧 婚 粉 紅 錁 絲 山 杉 飾 鷹 燕 裝 質 板 邊 箔 燈 漢 花 角 鏡 條 
羨=慕 嘆 
臨=時 走 死 頭 終 到 別 沂 行 近 街 了 門 危 場 床 界 帖 海 陣 安 摹 睡 盆 江 蓐 難 產 池 朝 風 高 機 朐 潼 刑 月 戰 汾 滄 城 川 河 濟 檢 客 清 泉 武 西 夏 湘 邑 漳 猗 沭 洮 澧 
鼓=勵 舞 掌 吹 書 動 樂 足 板 噪 手 角 的 勁 起 聲 樓 弄 浪 包 槌 出 搗 蕩 點 風 膜 氣 師 室 脹 成 面 皮 翼 
渾=身 濁 圓 厚 蛋 樸 江 名 然 如 噩 話 家 說 似 水 儀 
物=質 價 件 品 理 資 色 種 產 體 象 力 證 欲 像 歸 態 性 候 業 料 流 語 化 景 主 事 華 耗 故 鏡 情 探 外 議 權 
唱=歌 戲 詞 片 本 腔 法 道 段 機 歌 盤 會 出 得 了 到 著 游 起 碟 功 和 標 酬 付 名 票 曲 收 罷 響 
功=課 夫 勞 能 利 名 臣 用 效 德 績 業 過 力 勛 罪 底 架 率 高 耗 令 碑 放 
金=錢 子 色 光 石 銀 魚 黃 剛 屬 融 星 元 玉 發 價 條 蓮 庫 幣 礦 筆 質 龜 匾 手 環 猴 果 刀 球 榜 橘 牌 文 額 冠 針 箔 瘡 獎 甌 秋 鐘 曲 庸 城 門 龍 山 雞 飾 牛 寶 田 華 陵 卡 邊 像 花 鳳 器 工 水 橋 盾 蘭 絲 碧 沙 蝶 口 殿 表 風 珠 鋪 領 杯 鎊 昌 釵 丹 店 錠 婚 衡 粉 貴 瓜 鼓 甲 錁 塊 盆 松 湯 烏 牙 言 印 字 磚 鐲 兵 波 川 蛋 東 斗 紅 湖 匠 平 蛇 鎖 塔 壇 堂 碗 屋 溪 相 鄉 秀 葉 澤 寨 盞 鈿 
碰=到 見 壁 頭 撞 杯 上 面 巧 過 觸 車 擊 船 鎖 倒 破 傷 
稍=微 為 顯 停 具 許 后 有 作 遜 大 高 加 候 早 嫌 遲 等 低 事 慢 不 差 好 頃 息 小 遠 多 寬 傾 睡 退 
咖=啡 喱 
奴=隸 才 役 仆 婢 化 家 性 
棺=材 木 槨 柩 罩 
刺=激 刀 耳 兒 繡 殺 客 傷 史 眼 ? 探 青 槐 痛 死 鼻 穿 破 入 啦 棱 溜 撓 柏 骨 目 梅 配 頭 癢 針 字 棒 出 戳 花 孔 去 人 鼠 透 網 者 
窮=人 苦 困 盡 酸 鬼 途 舉 死 得 寇 的 追 國 期 乏 愁 蹙 漢 橫 根 究 竭 匱 忙 相 于 極 境 兇 
疲=倦 乏 勞 憊 軟 頓 弱 累 懶 敝 困 沓 
智=慧 力 能 斗 謀 取 育 利 略 囊 障 者 性 商 勇 人 齡 齒 術 光 巧 勝 
倘=若 使 然 或 有 能 未 佯 如 不 
索=性 要 取 引 證 吻 橋 賄 償 賠 尼 普 價 回 道 然 酬 還 購 解 寞 求 子 債 愛 命 
慚=愧 色 顏 怍 
村=子 里 莊 落 民 鎮 頭 野 前 寨 史 塾 學 中 上 一 口 屯 人 是 外 委 內 容 女 辦 邊 霸 隊 婦 話 姑 官 規 級 居 名 舍 俗 務 醫 長 組 夫 宅 
辛=苦 酸 勤 勞 辣 未 夷 亥 丑 醇 醛 炔 酮 烷 烯 酉 
姓=名 氏 李 劉 吳 薛 姚 朱 
損=失 害 傷 壞 耗 毀 益 人 
稿=子 費 件 紙 本 酬 約 薦 源 
嗓=子 音 門 
期=間 待 望 刊 中 限 滿 票 貨 末 終 內 指 權 數 盼 許 約 考 于 市 年 匯 房 冀 價 月 頤 求 
隔=壁 絕 膜 離 閡 斷 扇 江 成 音 板 開 鄰 夜 著 了 熱 天 聲 水 世 艙 日 周 山 行 房  心 河 間 
色=彩 情 澤 調 盲 鬼 帶 織 光 素 釉 子 的 相 變 魔 狼 系 譜 香 溫 味 差 度 筆 斑 弱 拉 膽 覺 霽 酒 迷 散 欲 粉 料 球 樣 
殺=人 死 害 戮 敵 氣 機 傷 手 去 盡 進 伐 軟 菌 價 滅 入 到 出 掉 蟲 場 戒 生 雞 得 豬 毒 掠 跌 青 身 熟 聲 頭 一 光 球 嬰 
禁=止 書 令 閉 忌 錮 煙 區 絕 欲 地 軍 例 臠 毒 制 食 藥 用 運 售 律 果 播 言 毀 獵 賭 放 火 核 牧 品 賽 受 衛 物 漁 卒 子 阻 酒 娼 
悄=然 聲 話 寂 地 
宿=舍 將 營 債 怨 命 敵 儒 弊 逋 仇 娼 根 世 土 夜 志 主 松 衛 州 醉 
確=實 定 信 切 鑿 立 認 證 保 診 是 有 知 乎 系 當 守 應 鑿 然 
念=書 頭 經 叨 珠 給 力 及 佛 著 舊 過 白 誦 物 錯 到 詩 咒 
強=烈 迫 盜 調 大 硬 壯 健 者 暴 奸 悍 人 制 力 權 國 弱 敵 占 盛 攻 求 辯 行 橫 勁 度 加 項 化 莊 省 軍 弓 突 吻 記 壓 渡 手 酸 的 勢 身 風 忍 光 逼 打 隊 效 要 檔 震 電 于 直 嘴 梁 令 韌 留 點 過 固 干 勁 將 堿 擊 使 似 笑 顏 作 拆 奪 拉 拍 取 娶 索 音 租 
咳=嗽 喘 血 得 痰 
浪=漫 費 花 頭 子 潮 人 蕩 濤 客 船 木 琴 峰 跡 尖 游 語 涌 
玩=藝 笑 具 耍 弄 物 味 偶 賞 命 友 好 齡 家 樂 意 法 到 了 完 過 火 水 轉 伴 忽 出 著 兒 票 球 興 膩 牌 一 
封=建 面 鎖 閉 條 套 口 存 皮 底 侯 到 權 山 地 里 泥 一 信 殺 為 神 裝 凍 固 識 包 印 嘴 蠟 王 盤 了 號 住 頂 帖 二 筆 禪 掉 堵 航 河 火 港 鏡 疆 禁 門 三 賞 四 土 齋 臣 好 緘 爵 開 庫 丘 入 死 網 邑 在 
譯=本 者 文 作 音 稿 名 著 筆 叢 員 注 為 碼 成 出 電 制 寫 述 錯 
樹=木 林 葉 枝 梢 干 根 立 身 叢 皮 苗 樁 杈 敵 狀 頂 型 種 膠 上 下 脂 人 影 德 碑 齡 墩 掛 冠 蛙 丫 籽 蔭 蔭 蜂 節 籬 名 旁 棚 起 神 薯 突 形 熊 液 
拚=命 
尾=巴 聲 隨 音 閭 部 樓 數 花 追 盤 礦 翼 燈 椎 骨 跡 款 氣 鰭 蚴 羽 子 標 端 眉 欠 形 注 
追=求 問 隨 逐 趕 究 憶 悼 尋 蹤 悔 擊 逼 溯 記 捕 述 查 加 敘 贓 認 討 捧 上 回 殺 訪 到 思 債 念 繳 著 打 索 肥 來 兵 補 償 懲 懷 風 還 根 剿 殲 慕 訴 授 尾 想 星 贈 過 獵 逃 
敘=述 說 談 舊 事 別 話 功 用 永 
按=照 說 時 理 摩 語 期 完 錯 鈕 此 揭 下 年 金 著 月 鍵 季 上 需 動 次 住 日 了 釘 扣 壓 例 捺 量 脈 周 鈴 倒 到 響 序 
辮=子 梢 
婆=家 媳 娘 姨 娑 母 嘴 家 子 
練=習 兵 功 達 出 就 到 成 琴 好 了 武 過 級 筆 隊 拳 手 攤 唱 劍 栓 字 
迷=信 人 惘 糊 住 惑 失 戀 離 茫 路 途 夢 宮 藥 霧 你 上 倒 津 幻 城 蒙 亂 彩 瞪 航 醉 陣 魂 死 
位=置 子 于 居 能 在 數 處 列 大 高 碼 相 移 圖 次 覺 勢 線 元 尊 
達=到 觀 成 官 夫 致 標 意 摩 賴 旦 因 川 道 縣 
狀=態 元 況 子 紙 貌 告 如 語 膠 
免=得 職 除 費 票 稅 燙 掉 遭 疫 責 受 于 去 收 提 進 試 談 禮 冠 官 檢 考 俗 刑 修 驗 役 予 征 罪 罰 
午=飯 后 餐 覺 前 時 間 休 宴 膳 夜 睡 安 茶 門 
數=目 量 學 字 落 據 只 張 語 本 碼 額 九 論 珠 列 位 十 年 的 月 百 個 以 天 值 千 次 日 萬 人 度 理 秒 表 家 倍 點 億 種 到 軸 座 組 控 載 錯 過 說 人 詞 叨 伏 制 筆 鈉 錢 完 
濟=南 困 世 公 寧 貧 水 事 慈 陽 源 
妓=女 院 
流=行 血 水 氓 下 露 動 言 傳 出 放 域 過 亡 浪 派 星 入 利 暢 通 落 沙 彈 毒 產 逝 寇 散 質 失 淌 經 形 溪 泉 民 氣 體 程 量 速 感 向 淚 于 轉 連 年 到 在 弊 汗 離 線 變 俗 明 進 竄 光 會 滿 麗 腦 布 標 別 播 蕩 芳 風 火 盡 盼 食 觴 矢 勢 蘇 網 瀉 徙 刑 涎 螢 溢 云 寓 血 電 掉 干 化 回 金 膿 配 砂 駛 式 涕 泄 音 注 鶯 
君=子 主 權 命 王 臣 臨 安 
孫=子 女 媳 臏 兒 權 文 儷 楠 寧 翃 ? 潔 氏 蜀 逖 興 遜 悅 武 吳 
繪=畫 圖 制 就 出 景 事 
紅=色 旗 花 臉 暈 木 葉 契 軍 燈 潤 腫 茶 眼 棗 豆 人 塵 星 薯 顏 粉 心 潮 蛋 包 利 柳 娘 票 果 糖 運 紫 柱 黃 綢 遍 筆 叉 銅 魚 案 棉 裝 貨 樹 松 酒 的 白 雨 股 綠 樓 磷 斑 牌 海 光 燒 梅 線 磚 參 麻 雀 壤 衛 火 衣 日 外 蓮 盤 字 疹 椒 唇 衫 河 毛 熱 螺 榜 布 幫 場 礬 樺 汞 警 角 凈 客 媒 煤 廟 區 漆 苕 生 杉 學 霞 樣 云 巖 艷 妝 燭 藻 橋 杏 安 城 丹 底 鶴 的 嫩 泥 袍 紗 桃 藤 頭 透 焰 玉 專 
皮=鞋 膚 包 箱 帶 鞭 毛 肉 球 襖 靴 子 貨 紙 面 衣 袋 蛋 匠 帽 囊 糖 椅 兒 革 層 質 花 棉 具 草 下 尺 輥 艇 影 制 脂 重 臉 黃 筏 猴 筋 件 夾 庫 袍 實 條 相 硝 炎 疹 張 墊 殼 孔 膜 山 特 線 屑 舟 
積=極 累 蓄 雪 水 壓 習 存 攢 聚 木 弊 欠 數 滿 案 肥 分 怨 溫 德 弱 勞 年 儲 淀 憤 垢 善 食 郁 云 冰 久 
苦=惱 痛 悶 笑 難 心 處 于 力 頭 命 干 楚 工 衷 味 澀 事 戰 行 海 功 境 學 練 水 雨 相 果 寒 活 竹 酒 主 瓜 的 樂 況 讀 戀 思 辣 差 情 短 勸 熬 勞 旅 人 臉 參 膽 斗 口 刑 夏 想 役 櫧 地 鹵 土 修 藥 汁 
調=查 子 和 動 皮 整 戲 停 劑 解 理 節 度 諧 教 養 遣 換 門 羹 人 勻 任 集 光 大 小 到 味 防 轉 撥 用 制 派 式 頭 運 離 校 控 適 職 研 到 回 唆 協 入 試 頻 出 情 來 料 幅 走 配 取 侃 令 類 弄 撥 包 茬 測 檔 函 護 赴 發 房 干 改 卷 溫 休 笑 演 閱 音 值 治 資 弄 處 成 換 合 好 號 干 價 級 經 濟 近 酒 降 減 上 速 色 謔 下 相 息 薪 兵 車 高 升 弦 性 正 準 
寡=婦 人 頭 言 陋 淡 合 歡 居 酒 母 情 妻 味 聞 欲 恩 
訓=練 話 導 令 斥 詞 誡 育 示 勉 誨 迪 讀 詁 教 喻 諭 責 
攔=住 阻 路 截 河 擋 擊 腰 網 洪 柜 劫 蓄 車 
供=給 養 應 奉 桌 銷 品 詞 狀 其 認 求 電 水 樓 人 貨 稿 需 出 職 氣 油 熱 暖 案 花 果 述 事 香 稱 體 血 
租=界 金 借 戶 賃 稅 用 貸 地 來 米 價 約 客 住 出 車 售 期 的 屋 給 契 房 船 下 費 讓 佃 錢 子 
請=客 求 教 愿 問 假 示 帖 柬 罪 功 戰 按 電 勿 你 于 人 到 將 用 選 向 他 來 您 看 我 辭 多 見 進 聽 予 轉 回 安 纓 命 便 調 賞 托 降 坐 老 援 
嫂=子 
輪=船 廓 流 子 回 渡 胎 轉 機 班 換 椅 軸 作 番 帶 空 到 替 值 圈 奸 輻 形 調 盤 埠 次 唱 齒 滑 轂 距 牧 生 輞 訓 休 系 養 種 蟲 錘 對 崗 箍 式 臺 詢 緣 狀 
格=外 子 式 言 調 律 局 斗 里 林 物 網 殺 致 拉 勒 力 柵 
擴=大 張 充 展 散 寬 建 編 軍 增 孔 音 印 容 版 產 股 權 銷 招 
尊=敬 重 嚴 貴 崇 稱 長 容 姓 處 府 駕 親 榮 者 為 卑 師 奉 號 翁 
基=礎 本 督 于 地 金 石 調 業 點 輔 層 拉 因 數 建 準 隆 線 期 根 極 座 爾 部 諾 肥 干 價 腳 坑 色 態 體 團 薪 巖 站 質 址 板 波 材 帶 德 多 頻 元 
秋=天 風 雨 千 季 水 色 冬 波 收 意 景 分 楓 蟲 思 菊 毫 月 播 耕 糧 日 汛 游 田 涼 令 蟬 菜 后 光 灌 瑾 末 試 霜 聲 熟 實 闈 征 暮 夕 干 葵 山 葉 夜 種 
雪=白 花 茄 亮 人 片 景 山 恥 蓮 夜 水 原 堆 海 柳 飄 萊 膚 橇 梨 團 崩 糕 松 柜 地 兒 條 藏 中 頂 鞋 球 災 豹 暴 村 車 雕 恨 峰 霽 盲 青 糝 天 線 野 冤 子 碧 堤 后 祭 犁 泥 羞 域 
味=道 精 覺 甜 蕾 美 兒 全 素 
順=著 手 便 利 口 眼 從 心 民 當 應 風 序 路 勢 腳 耳 暢 遂 次 帶 差 和 延 服 道 流 境 昌 天 時 子 滑 祝 致 乎 溜 變 產 達 導 訪 奸 價 氣 情 水 受 向 意 義 治 嘴 承 化 平 
鬼=子 臉 神 混 魂 話 怪 蜮 胎 祟 火 魅 迷 城 谷 畜 啊 的 佬 屋 才 斧 物 雄 臼 門 魔 性 影 
奮=斗 發 勇 戰 力 而 進 起 然 飛 激 袂 勉 爭 
綠=色 葉 豆 蔭 林 化 地 洲 燈 茵 藻 茶 影 山 毛 柳 海 波 軟 肥 的 卡 野 水 樹 意 草 帽 籬 黨 礬 光 盤 營 竹 森 城 春 島 汀 衣 玉 裝 
嘲=笑 弄 諷 罵 謔 
絲=毫 襪 綢 絨 線 綿 織 竹 弦 瓜 光 糕 印 路 帶 網 質 米 紡 錐 狀 寶 蟲 極 膠 
呼=吸 聲 喚 號 喊 嘯 吁 應 叫 哨 救 哧 氣 出 機 喝 啦 嚕 隆 扇 臺 延 蘭 瑪 入 市 
專=門 家 制 心 業 員 用 號 欄 政 題 一 橫 長 車 刊 賣 誠 著 攻 利 電 名 人 科 程 權 差 集 使 修 向 責 輯 治 兼 愛 案 斷 訪 職 款 為 訊 區 注 線 營 項 屬 有 供 文 柜 書 場 論 機 函 設 任 指 發 事 戶 帖 版 列 辦 干 管 稿 控 美 署 擅 史 銷 席 座 殺 遞 司 網 
義=務 氣 憤 士 女 子 父 旗 賣 理 利 學 冢 演 戰 舉 師 塾 工 診 肢 倉 齒 地 軍 捐 母 拍 賽 項 勇 律 民 烏 行 莊 
侵=略 犯 入 占 襲 蝕 害 擾 吞 權 華 奪 凌 晨 曉 越 早 
叔=父 母 祖 公 伯 婆 侄 子 
煩=惱 躁 亂 擾 囂 瑣 死 勞 請 悶 憂 我 人 你 惡 膩 冗 不 神 心 言 瀆 
氣=味 氛 息 象 派 概 候 力 憤 魄 質 色 勢 度 節 悶 韻 話 焰 球 量 喘 運 體 功 壓 溫 管 流 泡 極 孔 虛 筒 性 宇 餒 得 相 槍 動 絕 袋 血 墊 化 了 缸 結 割 腫 死 態 走 閥 急 旋 層 促 數 人 浪 惱 囊 泵 粗 窗 錘 短 焊 根 鍋 井 口 門 脈 煤 盛 煞 團 頭 田 胸 眼 炸 滯 壯 冷 樓 密 腔 蝕 學 閘 
培=養 植 育 訓 土 基 根 修 
適=當 宜 應 合 用 于 才 意 值 中 度 口 時 量 齡 逢 切 航 銷 任 婚 
乃=是 至 由 爾 東 父 
耽=誤 擱 于 溺 
筷=子 
崇=拜 高 敬 尚 洋 德 光 信 明 阿 奉 仰 禎 禮 慶 仁 文 陽 義 佑 左 
避=免 暑 開 難 諱 風 談 孕 震 過 雨 忌 稅 寒 嫌 讓 亂 世 邪 風 短 光 禍 見 雷 匿 席 險 役 
冒=險 充 失 煙 雨 火 犯 牌 汗 進 雪 頭 號 尖 出 著 起 用 死 名 領 場 頂 瀆 功 昧 泡 稱 口 血 
炸=彈 毀 藥 開 醬 船 房 了 魚 死 壞 雞 傷 裂 雷 掉 斷 鍋 糕 窩 響 成 平 破 碎 
協=會 調 助 作 定 同 力 商 議 防 辦 和 奏 理 約 查 管 
僅=只 容 獲 供 為 有 是 在 能 得 存 作 占 是 用 此 靠 對 限 就 見 指 剩 憑 從 管 
偷=看 懶 聽 盜 竊 走 閑 人 襲 運 歡 出 過 渡 稅 情 拍 窺 去 取 雞 笑 心 拿 漏 安 獵 兒 吃 換 空 摸 巧 生 手 逃 眼 越 營 嘴 得 電 工 來 壘 跑 錢 地 用 
珍=珠 貴 重 惜 寶 藏 本 愛 視 奇 品 聞 異 禽 玩 妮 稀 存 攝 饈 
紛=亂 擾 飛 爭 繁 紜 呈 綸 披 雜 落 墜 
貢=獻 緞 品 物 賦 奉 酒 米 生 稅 院 嘎 
樂=意 觀 得 趣 園 山 器 于 隊 府 曲 土 章 音 譜 一 坊 團 舞 律 壇 施 天 而 道 理 事 業 師 安 和 了 平 兒 段 果 子 池 感 迷 聲 手 業 凱 至 
袖=子 口 珍 管 筒 章 標 箭 套 孔 扣 手 
鞠=躬 萍 育 養 
福=建 氣 州 音 利 分 相 地 星 柯 到 橘 特 祉 岡 田 將 安 山 蔭 報 海 壽 娃 臨 晉 運 王 鼎 禮 林 清 泉 神 
尋=找 常 求 覓 思 死 訪 釁 根 租 芳 來 著 回 寶 人 歡 索 夢 到 幽 味 出 呼 機 摸 親 事 食 聲 隙 醫 繹 蹤 址 跡 問 烏 
統=治 一 制 計 共 帥 稱 轄 率 招 籌 考 戰 攝 合 領 購 練 分 貨 觀 管 攬 編 帶 建 配 盤 屬 通 銷 鋪 御 馭 
囑=咐 托 告 
控=制 訴 告 煙 股 球 購 管 件 盤 申 
肯=定 說 不 干 綮 亞 于 
握=手 住 別 筆 有 力 著 的 緊 拳 
江=南 蘇 西 山 湖 水 北 河 流 輪 油 民 天 米 津 蘺 門 城 漢 上 東 口 浙 中 邊 淮 戶 陵 岸 潮 段 防 皋 面 畔 豚 濤 心 陰 總 渚 島 青 川 村 堤 都 海 華 姐 寧 平 浦 灘 永 州 
娃=子 生 魚 兒 親 臉 
垃=圾 
戒=指 煙 嚴 備 心 律 除 網 了 尺 刀 條 毒 掉 酒 斷 牒 規 懼 
罪=惡 過 名 狀 人 犯 孽 行 案 責 證 魁 愆 戾 錯 情 囚 刑 尤 
武=器 漢 裝 力 昌 松 將 士 人 藝 斷 術 功 官 戲 俠 打 林 生 工 斗 夫 備 旦 技 品 藏 行 場 丑 劇 廟 職 警 當 學 帝 陵 略 臣 大 火 鋼 舉 庫 師 壇 安 城 川 定 岡 進 鳴 寧 平 強 清 僧 勝 威 衛 鄉 穴 夷 義 陟 
征=服 求 文 集 兆 象 收 兵 戰 伐 候 詢 稿 途 繳 召 討 調 塵 用 程 地 稅 得 婚 人 引 糧 訂 答 帆 發 購 管 歌 募 聘 實 
醒=來 悟 目 酒 眼 豁 覺 了 獅 腦 木 脾 著 
莫=非 不 大 若 要 笑 讓 可 測 名 屬 說 爾 如 道 及 忘 能 過 愁 逆 怪 將 邪 問 敵 
財=產 富 主 政 神 力 物 寶 閥 源 貿 權 務 東 團 路 迷 運 勢 帛 會 經 稅 貨 年 界 氣 險 長 賦 校 
指=出 揮 導 示 頭 點 甲 定 望 教 使 尖 責 南 向 明 引 正 派 紋 名 令 控 針 標 間 印 法 事 數 骨 環 在 稱 的 著 摘 為 證 日 斥 路 壓 認 撥 畫 供 節 靠 仗 錯 代 縫 痕 鍵 距 套 要 
痕=跡 量 
嘆=息 氣 服 詞 道 號 絕 賞 惋 惜 羨 
試=驗 看 探 問 看 想 用 圖 行 題 卷 管 裝 訓 駕 打 錯 辦 樣 制 紙 點 劑 種 飛 院 過 聽 算 著 車 射 論 場 教 穿 作 工 鏡 做 銷 讀 映 演 播 筆 表 產 唱 航 婚 崗 講 刊 手 投 一 吃 訂 件 片 跳 藥 衣 針 
衙=門 役 內 署 
臥=室 病 鋪 床 車 榻 倒 具 艙 底 龍 房 佛 軌 式 射 槽 下 姿 
善=于 良 意 心 人 后 本 事 終 睞 用 惡 行 待 報 變 根 舉 哉 性 為 言 戰 類 感 辯 書 文 因 
滑=稽 頭 竿 膩 冰 入 潤 翔 車 梯 動 輪 雪 落 坡 板 的 水 倒 行 槽 結 橇 鼠 下 到 過 ? 道 軌 精 降 石 爽 膛 音 移 出 閥 蓋 塊 壘 面 脫 線 走 
膽=子 量 小 怯 大 氣 敢 力 瓶 識 顫 囊 略 汁 道 礬 寒 管 堿 魄 酸 虛 壯 石 
海=軍 上 棠 外 洋 岸 水 里 面 內 風 關 灘 波 派 潮 船 島 峽 盜 燕 底 報 員 口 浪 戰 帶 灣 嘯 味 參 禁 藻 鷗 鹽 量 碗 鮮 防 港 龍 南 獅 綿 拔 馬 鳥 珠 通 青 北 涵 流 路 星 魚 運 產 貍 螺 難 事 獺 葬 菜 堤 狗 輪 圖 震 景 濱 域 區 邊 中 豚 天 地 床 倫 陸 牙 濤 疆 爾 寧 東 角 塘 蜇 龜 道 神 商 頓 霞 安 城 山 航 德 豹 王 信 牛 藍 聊 草 淀 膽 釣 貨 匪 河 魂 歸 溝 椒 寇 況 葵 米 鰻 盆 侵 清 撒 獸 損 退 涂 選 西 象 蟹 熊 協 蜒 隅 子 豬 貝 豐 峰 怪 會 進 林 嶺 錨 門 瑞 扇 生 蝕 兔 蝦 相 興 陽 原 賊 鷲 
娘=家 子 舅 胎 腔 兒 們 親 姨 
鮮=明 花 紅 艷 血 卑 美 果 味 嫩 魚 食 肉 貨 菜 有 奶 活 甜 見 亮 麗 靈 綠 潤 貝 蛋 妍 于 
鈔=票 
拳=頭 術 師 腳 擊 棒 王 手 打 套 法 聯 皇 譜 曲 壇 賽 
抱=怨 歉 負 病 屈 恨 著 有 持 住 起 緊 恙 憾 她 他 定 愧 拳 團 窩 養 冤 去 頭 一 
與=否 其 會 它 人 我 他 你 此 她 之 您 民 共 君 誰 聞 格 門 
秩=序 
牙=齒 刷 關 簽 膏 粉 根 醫 床 牌 齦 慧 口 磣 雕 科 痛 輪 白 縫 垢 祭 具 儈 婆 色 石 髓 質 缸 花 式 線 音 
葉=子 
諸=位 侯 如 神 多 事 般 國 葛 君 子 公 城 方 家 言 暨 
滋=味 潤 長 養 生 補 事 擾 陰 蔓 芽 育 
架=子 勢 空 橋 構 設 上 起 次 在 好 接 豆 線 
管=理 事 家 束 教 子 保 轄 用 制 壁 不 見 道 窺 區 工 路 治 的 他 顧 控 線 它 得 內 帶 弦 狀 好 網 樂 材 段 護 界 井 片 押 涌 自 仲 箍 件 腳 殼 口 紗 一 住 
景=象 物 色 致 況 仰 點 觀 天 美 深 氣 區 山 慕 頗 泰 遇 德 洪 教 寧 縣 行 
急=忙 于 切 促 速 流 躁 事 救 進 病 迫 電 劇 性 需 難 務 用 診 雨 剎 襲 癥 智 湍 彎 件 升 得 降 遽 待 步 了 走 轉 變 案 茬 火 風 眼 要 驟 奔 沖 飛 趕 就 拉 駛 灘 行 語 運 奏 
逃=走 避 難 跑 亡 學 命 脫 遁 兵 生 荒 散 竄 奔 犯 離 出 去 到 稅 過 往 逸 回 匿 敵 婚 反 匯 課 票 席 債 掉 歸 開 路 妻 入 騰 
臺=灣 階 北 詞 燈 風 面 基 子 布 山 步 數 長 球 歷 地 本 鉆 上 幣 商 中 下 南 前 海 獨 東 式 資 港 后 語 聯 盟 秤 架 鑒 端 胞 筆 甫 駕 盤 鉗 屬 扇 柱 州 鐘 安 車 江 輪 賬 座 
暗=示 中 淡 殺 笑 自 號 室 處 想 娼 箭 算 影 探 喜 溝 藏 花 礁 昧 扣 閣 害 流 鎖 語 疾 計 器 傷 箱 瘡 戀 的 涌 地 堡 黑 諷 渠 喻 紅 里 補 場 潮 道 洞 含 盒 話 訪 房 合 火 河 灰 井 記 碼 盤 下 沙 哨 射 事 灘 香 匣 線 夜 轉 黃 抓 紫 點 斗 管 門 色 指 
論=文 調 理 戰 爭 壇 述 斷 著 據 點 證 道 個 處 罪 題 及 者 到 語 集 說 叢 衡 法 難 辯 敵 功 價 件 域 
鄭=重 州 碼 和 昊 鈞 氏 
距=離 今 
墮=落 入 胎 地 馬 
京=城 戲 劇 師 都 派 腔 杭 哈 白 廣 山 華 滬 東 官 津 報 菜 胡 海 郊 畿 味 西 族 兆 九 韻 
住=處 宅 址 家 院 所 房 戶 宿 手 地 腳 在 屋 進 過 下 口 民 讀 店 居 校 嘴 
辯=論 護 解 駁 白 明 才 證 士 稱 難 詞 手 說 題 誣 學 正 
羅=馬 列 漢 圈 織 盤 格 致 文 鍋 琦 
褲=子 腳 腰 帶 腿 兜 襠 衩 頭 袋 縫 管 裙 筒 襪 線 裝 
猛=然 烈 虎 獸 攻 士 沖 撲 打 將 醒 料 轟 跌 禽 增 片 火 力 敲 咬 男 藥 地 進 擊 勁 可 升 省 漲 鷙 子 追 吃 刺 奪 漢 降 拉 扭 拋 犬 投 推 襲 炸 擲 撞 揍 
允=許 諾 準 承 當 武 
純=粹 潔 樸 正 熟 凈 真 屬 青 平 利 種 情 白 金 的 一 度 銀 音 美 良 色 然 藍 化 黑 厚 鋼 堿 毛 品 水 稚 貞 愛 棉 清 摯 
巨=大 人 響 款 浪 靈 著 幅 商 頭 匠 輪 資 子 變 額 流 星 型 獻 痛 騙 乳 象 細 富 蟹 龍 石 擘 量 賈 慢 貪 萬 蜥 作 制 禍 鯨 鹿 鳥 手 獸 樹 物 像 野 涌 蟒 
裝=飾 作 束 扮 備 訂 箱 修 置 假 殮 運 潢 載 有 貨 甲 配 下 過 幀 船 裱 卸 車 設 上 的 在 機 滿 出 入 成 著 好 進 得 造 到 傻 料 懂 點 瘋 裹 窮 腔 蒜 填 完 碗 相 熊 樣 病 袋 彈 罐 具 睡 死 
圈=子 套 椅 點 在 內 閱 外 肥 養 攏 兒 操 定 地 選 占 環 里 起 中 
徘=徊 
舌=頭 戰 苔 音 根 骨 狀 尖 耕 炎 鰨 
聯=系 合 想 絡 盟 軍 結 邦 名 大 歡 手 姻 會 鎖 勤 防 運 網 機 賽 通 辦 誼 署 營 席 電 袂 華 立 隊 展 社 播 保 考 成 動 苯 唱 產 戶 句 翩 體 銷 演 眾 奏 票 組 璧 
取=得 出 消 笑 材 樂 舍 經 暖 巧 悅 締 代 道 勝 信 給 景 值 藥 石 證 保 決 齊 樣 向 回 用 自 其 名 貨 下 利 去 走 到 碼 之 過 水 來 款 法 義 鬧 平 錢 詞 反 物 
斷=定 絕 送 然 言 氣 語 頭 臂 奶 案 裂 炊 針 貨 過 層 后 開 糧 代 交 面 點 路 了 腸 線 電 齒 想 獄 枝 續 水 市 橋 流 壟 乳 壁 檔 頓 航 喝 魂 乎 根 句 碼 片 七 弦 崖 肢 折 種 指 掉 離 念 去 腿 
湖=南 北 水 畔 色 澤 泊 沼 景 底 田 筆 人 邊 上 面 海 區 藍 綠 濱 汊 廣 光 怪 盆 灘 心 州 岸 口 名 羊 
童=話 年 心 子 工 男 裝 謠 音 貞 鞋 女 仆 山 便 軍 真 聲 稚 車 蒙 趣 生 傘 星 顏 
推=開 測 翻 動 薦 辭 敲 進 行 出 想 廣 舉 倒 銷 斷 論 崇 托 移 理 算 卸 卻 讓 拿 向 選 遲 脫 射 手 子 介 展 到 定 上 說 門 演 掉 諉 入 著 力 給 究 車 的 搪 求 重 許 導 下 拒 刨 戴 宕 度 服 桿 故 及 擠 見 磨 搡 事 頭 土 問 謝 延 衍 知 誠 擋 后 回 挽 優 
憂=郁 愁 慮 傷 患 心 悶 國 色 懼 思 憤 煩 戚 悒 沉 急 民 人 容 
限=制 于 度 量 定 期 流 高 額 時 產 價 水 令 電 購 界 養 止 幅 速 位 至 
胳=膊 臂 肢 
顫=動 抖 栗 音 悠 聲 巍 
甘=心 苦 蔗 肅 愿 于 露 泉 美 雨 草 甜 霖 州 休 當 油 孜 菊 汞 地 冒 南 藍 冽 醇 服 居 萍 薯 受 味 為 洛 松 汁 
含=笑 糊 淚 蓄 義 羞 混 意 冤 量 有 著 鎂 硼 水 怒 苞 悲 憤 恨 情 蘊 怨 愁 鈣 山 糖 鋅 血 鹽 氧 油 
詫=異 愕 然 
偏=見 僻 愛 重 激 向 心 袒 方 差 廢 鋒 遠 旁 巧 聽 難 前 后 右 近 的 癱 護 下 轉 光 離 低 高 軟 好 頗 要 執 于 析 食 左 西 私 南 安 移 漏 勞 流 大 殿 房 航 將 角 科 枯 門 盲 衫 生 師 題 疼 斜 信 小 振 關 冷 色 上 失 狹 壓 倚 置 
子=女 弟 孫 彈 夜 書 宮 口 規 音 集 鍵 代 房 目 葉 句 民 曰 表 時 母 路 嗣 囊 ? 部 城 堤 息 弦 虛 婿 媳 域 侄 豺 兒 婦 爵 
妥=當 協 帖 善 實 否 加 便 靠 貼 
胖=子 妞 的 的 墩 了 瘦 
娛=樂 悅 
座=位 談 子 椅 瘡 橋 鐘 艙 次 落 駕 墊 充 兒 號 機 客 
樓=梯 房 板 臺 閣 道 前 門 宇 蓋 群 價 市 盤 面 下 上 層 花 內 座 頂 主 體 蘭 船 里 
移=動 植 居 民 交 栽 送 至 到 除 師 走 位 入 轉 往 去 開 向 情 步 錄 防 解 行 易 用 出 調 近 局 來 碼 苗 山 數 項 置 注 
緩=和 慢 步 沖 急 釋 繳 過 解 期 刑 存 流 辦 地 建 坡 氣 行 限 醒 役 一 征 滯 手 
骨=頭 肉 灰 節 氣 干 髓 牌 子 架 骼 折 血 力 朵 學 質 科 胳 癌 刺 碌 齡 料 雕 ? 粉 化 鯁 感 庫 膜 盆 器 針 骸 盤 
倫=敦 理 次 巴 常 比 琴 
姿=態 勢 色 容 
識=字 破 貨 別 得 見 趣 辨 才 家 荊 相 羞 記 途 
孤=獨 兒 寂 立 單 島 身 苦 僻 傲 高 軍 魂 煙 山 帆 本 寡 星 寒 老 女 弱 殘 城 膽 峰 拐 孀 行 雁 證 眠 云 燈 墳 零 陋 旅 舟 
襪=子 筒 套 船 底 帶 
竭=力 盡 誠 
慶=祝 賀 幸 典 功 生 歷 壽 陽 安 元 云 
屁=股 話 顛 事 眼 
展=開 覽 出 示 現 翅 望 期 顏 品 銷 室 區 板 會 露 館 廳 播 教 臺 演 架 廊 緩 柜 寬 賣 評 售 團 位 性 映 業 牌 線 
欺=騙 侮 負 凌 壓 詐 瞞 世 人 客 君 生 辱 蒙 罔 哄 要 
邊=上 緣 疆 境 際 界 遠 城 門 區 防 裁 關 塞 框 音 寨 說 看 走 沿 陲 材 線 貿 學 地 檢 岸 兒 鋒 幅 角 款 卡 民 式 事 務 隘 長 帶 干 講 距 沁 飾 為 寫 
轎=子 夫 車 
毀=滅 壞 約 棄 謗 了 譽 掉 容 于 損 林 害 減 
爭=取 論 奪 吵 辯 斗 執 持 先 相 端 光 鳴 權 議 芳 頂 春 球 購 嘴 霸 戰 勝 逐 氣 著 得 寵 雄 鋒 創 臉 鬧 辦 當 衡 競 搶 強 優 艷 價 
蒼=蠅 白 茫 老 涼 天 松 翠 山 龍 穹 鷹 鷺 頭 生 潤 耳 黃 勁 啞 郁 術 南 鵬 
單=純 獨 調 位 身 薄 子 刀 弦 衣 間 字 據 數 干 一 元 褂 褲 篇 弱 向 瓣 幫 詞 選 科 擺 打 方 個 騎 色 被 車 性 機 句 面 線 張 靠 是 人 親 程 憑 日 邊 從 價 項 就 層 曲 手 顯 列 證 月 蹄 擊 相 行 戀 用 體 杠 門 作 挑 傳 眼 說 片 排 反 于 另 利 寧 兵 產 側 是 點 碟 端 寒 核 幅 發 號 峰 軌 果 過 鍵 晶 交 家 口 孔 抗 皮 槍 雙 絲 設 帖 糖 條 腿 文 姓 葉 音 質 只 板 比 步 槽 飛 極 季 卡 模 斜 義 足 座 
場=面 合 所 子 地 院 次 下 景 上 內 館 外 主 區 租 記 論 強 務 長 站 址 點 頻 ? 
府=上 城 邸 內 庫 谷 尹 
富=貴 有 于 裕 翁 人 強 農 麗 豪 足 余 庶 饒 源 甲 比 態 的 士 商 山 國 戶 寧 家 康 邦 民 含 平 產 集 礦 婆 實 順 縣 陽 蘊 孀 
糧=食 草 票 荒 廣 餉 袋 庫 稅 價 秣 站 倉 油 店 農 道 戶 行 棉 區 商 田 囤 棧 
滅=亡 絕 種 口 害 火 門 蟲 鼠 劍 茬 頂 跡 菌 失 殺 蠅 族 燈 掉 蚊 
菩=薩 提 
肉=體 麻 欲 皮 色 身 片 食 松 眼 餅 醬 類 棒 盾 彈 桂 丸 冠 排 刑 票 豬 質 搏 峰 贅 絲 湯 痛 瘤 牛 案 畜 店 丁 紅 感 鴿 干 雞 糜 末 脯 鋪 禽 鰭 頭 兔 餡 用 芽 鴨 羊 汁 凍 販 果 香 粽 
猜=想 測 疑 度 謎 中 錯 到 忌 出 拳 摸 透 嫌 得 斷 對 著 
凄=涼 慘 愴 婉 厲 然 冷 楚 惻 惶 苦 迷 清 切 惘 咽 美 
歸=來 于 宿 途 國 入 納 結 還 心 并 隊 屬 鄉 鳥 謬 鴻 案 順 公 總 程 檔 僑 附 向 類 咎 宗 家 依 化 真 到 根 去 正 人 位 因 天 隱 西 路 攏 寧 除 回 航 功 卷 集 降 口 期 齊 省 田 陰 罪 葬 整 置 著 巢 零 約 
叢=書 刊 林 生 談 里 集 葬 脞 刻 莽 密 山 雜 冢 中 
抽=屜 出 象 煙 身 泣 空 動 簽 搐 調 水 打 查 穗 芽 樣 風 筋 獎 取 離 咽 中 測 成 兒 掉 搭 丁 斗 換 檢 緊 考 球 絲 稅 縮 紗 殺 薹 逃 頭 閑 選 驗 印 走 彩 插 點 回 汽 上 吸 血 運 搦 
侮=辱 罵 蔑 
盒=子 裝 內 帶 飯 式 蓋 
園=子 地 丁 林 藝 圃 田 內 區 中 里 陵 容 囿 長 
競=爭 賽 選 走 相 技 投 逐 猜 價 標 渡 答 崗 買 賣 拍 聘 速 銷 秀 艷 購 試 
飯=店 碗 后 館 菜 食 廳 桌 桶 鋪 鍋 錢 莊 堂 量 前 盒 票 局 粒 囊 口 團 轍 
筆=記 墨 下 名 直 法 跡 調 尖 力 桿 者 觸 畫 鋒 端 頭 談 挺 筒 意 勢 套 錄 致 架 帽 油 仙 試 誤 譯 札 算 洗 路 友 順 資 形 盒 立 潤 答 伐 會 耕 供 管 受 體 芯 削 硯 債 戰 政 刀 底 
百=姓 年 靈 萬 貨 般 合 出 分 獸 戰 念 佳 步 來 帖 樓 多 家 科 名 元 億 人 個 變 余 米 計 花 位 態 點 事 感 倍 種 業 鳥 病 歲 里 忙 川 代 字 物 草 世 葉 日 官 部 度 分 十 戲 寶 次 發 戶 會 集 克 兩 畝 強 色 升 思 丈 
被=捕 窩 子 迫 褥 里 動 告 單 害 頭 俘 面 阻 疑 禁 它 秒 套 覆 罩 袋 服 臥 人 判 控 殺 問 困 扣 炸 拒 他 騙 逼 罰 打 我 愛 盜 她 查 你 劫 搶 毀 綁 抓 偷 刺 炒 刪 黑 捉 罵 難 絮 堵 封 奸 叫 虜 器 誰 占 
鎮=靜 定 壓 守 日 子 紙 委 星 海 江 上 痛 尺 反 服 長 宅 住 暴 康 里 民 寧 坪 平 區 遠 賚 
次=日 數 序 要 之 第 等 子 女 郎 生 級 的 或 年 比 于 方 品 貨 韻 長 晶 
藍=色 布 天 本 靛 圖 紫 貓 田 的 領 牙 調 光 礬 鯨 屏 沁 雪 雨 藻 帶 軍 鳥 
孟=子 買 浪 春 冬 軻 秋 夏 欣 堯 德 津 連 縣 
字=眼 典 句 條 畫 樣 跡 母 號 面 匯 兒 形 體 紙 音 據 幕 帖 海 距 塊 量 盤 首 線 序 譯 書 幅 模 節 詞 型 數 段 頭 符 義 庫 集 表 根 碼 串 元 源 謎 鍵 組 頻 長 調 旁 
蝴=蝶 
廢=話 物 墟 除 品 止 紙 人 棄 鐵 料 置 黜 票 氣 水 酸 舊 詞 然 弛 學 液 油 渣 址 城 船 地 鋼 立 土 
枕=頭 套 木 在 芯 骨 席 心 巾 邊 墊 藉 上 
陸=續 軍 地 路 空 運 毅 游 
吸=引 煙 收 取 氣 力 過 到 走 盤 納 入 毒 食 水 者 塵 進 吮 附 管 溜 熱 儲 濕 蟲 出 回 墨 上 聲 頭 血 住 
喉=嚨 頭 舌 音 管 結 部 癌 風 炎 鏡 科 
朦=朧 
鐵=路 匠 門 流 牛 鏈 絲 道 青 軌 床 橋 錘 甲 塔 工 索 筋 器 鍬 板 證 鍋 皮 環 桶 窗 餅 錨 棍 蹄 馬 騎 拳 棒 活 紗 筆 軍 ? 砂 柜 漢 礦 人 心 鎬 管 花 樹 水  的 閘 質 定 架 腕 欄 通 釘 籠 芯 罐 片 面 掌 案 臂 廠 打 銚 搭 畫 灰 黑 紅 桿 ? 箍 弓 鋏 鎧 幕 耙 鎖 石 杉 柵 勺 條 血 屑 鹽 砧 叉 鏟 彈 蛋 粉 斧 杠 鉤 骨 盒 塊 力 良 嶺 鉗 撬 球 圈 山 手 托 箱 柱 嘴 
夢=想 見 境 幻 話 鄉 縈 圓 系 回 斷 蝶 戰 遺 中 里 醒 魘 游 到 露 寐 魂 囈 秋 神 兆 
混=亂 蛋 合 沌 雜 戰 飯 入 和 淆 進 同 勻 到 輸 著 事 兒 在 音 編 雙 成 了 充 紡 跡 拼 聲 響 用 一 養 賬 過 排 頻 水 血 作 
鴨=子 蛋 絨 嘴 舌 梨 類 掌 黃 肉 
=壁 角 根 頭 腳 基 報 紙 上 邊 面 垣 布 垛 皮 裙 圍 縫 體 
陌=生 上 路 
判=斷 決 定 處 官 別 刑 賠 案 明 例 罰 給 罪 詞 令 離 讀 分 據 變 匪 軍 亂 
鄰=居 近 家 舍 座 里 邦 國 省 縣 接 人 村 角 水 域 
躲=開 避 閃 藏 著 債 在 到 進 過 讓 懶 好 
傾=向 聽 吐 倒 訴 瀉 斜 注 軋 覆 銷 談 力 心 卸 慕 城 情 角 巢 側 囊 耳 動 國 盆 灑 塌 羨 出 船 度 入 泄 
誠=懇 實 然 心 意 摯 樸 篤 信 邀 如 聘 征 屬 服 愿 招 
市=民 場 面 鎮 儈 集 價 政 區 容 郊 委 域 招 布 制 值 況 道 內 府 井 級 里 外 尺 畝 屬 立 電 話 兩 寸 花 房 徽 惠 斤 賈 聲 肆 民 長 際 貌 縣 直 
冤=枉 屈 家 案 仇 孽 魂 獄 情 苦 氣 錢 死 恨 
角=色 落 度 門 逐 力 化 票 斗 質 球 膜 色 力 樓 兒 尺 鋼 果 鐵 錐 巖 柱 狀 鯊 
紹=興 酒 介 劇 
境=界 遇 地 內 況 域 外 肚 
沿=著 途 海 用 線 岸 兒 襲 邊 路 江 河 例 街 
寧=可 靜 愿 波 肯 夏 為 和 謐 死 日 德 靖 親 帖 馨 安 城 岡 國 海 河 化 津 晉 陵 南 強 陜 武 鄉 陽 要 遠 
牢=騷 獄 靠 籠 房 固 記 中 穩 度 門 實 頭 地 
獅=子 鷲 城 王 
貴=族 重 人 姓 州 賤 客 陽 賓 妃 國 恙 池 的 校 子 廠 省 婦 地 庚 干 戚 胄 報 定 方 港 局 刊 所 體 溪 院 站 
草=地 木 帽 棚 鞋 原 案 坪 率 叢 房 藥 席 紙 稿 繩 場 根 擬 料 皮 書 莽 字 創 屋 薦 芥 綠 野 包 種 屯 類 ? 澤 荒 灰 圖 本 果 寇 莓 體 菇 堂 就 民 雞 簾 人 編 測 蟲 袋 墊 堆 垛 碼 昧 棉 簽 食 酸 灘 寫 魚 葉 約 樣 賊 叉 甸 稈 黃 鋪 圣 洼 籽 
司=令 機 法 儀 徒 庫 鐸 馬 爐 南 號 鼓 空 寇 務 藥 長 職 晨 
駱=駝 馬 
嫉=妒 恨 
節=目 日 奏 省 制 烈 約 拍 后 儉 氣 育 操 令 錄 略 假 本 子 律 能 慶 食 流 煤 前 點 欲 油 水 用 哀 禮 電 婦 減 選 下 余 要 支 肢 會 間 結 孔 民 片 義 
旗=袍 人 幟 子 號 桿 手 山 語 下 艦 魚 標 竿 
淘=氣 汰 來 金 籮 換 米 神 洗 析 選 
私=人 下 塾 心 事 自 有 貨 產 情 仇 利 房 見 通 蓄 娼 欲 法 信 話 刑 營 交 囊 聊 服 拆 了 宅 念 圖 章 憤 黨 隱 家 立 語 拿 密 用 訪 藏 價 處 奔 邸 分 活 函 方 販 股 企 設 商 吞 梟 學 怨 益 鹽 養 衷 罰 費 酒 賣 釀 室 鑰 運 
哭=聲 泣 喊 叫 訴 吧 過 啼 鬧 別 靈 窮 腔 喪 砂 出 
兵=士 丁 力 營 變 艦 役 器 馬 火 家 法 權 卒 船 種 亂 書 站 團 戈 痞 戎 源 分 敗 部 車 笛 符 工 革 諫 棋 餉 員 勇 蟻 足 災 備 禍 甲 將 刃 舍 學 殷 制 
修=養 改 理 飾 辭 正 建 好 補 行 訂 復 整 路 煉 繕 筑 剪 女 葺 造 鞋 橋 過 腳 士 配 枝 學 身 習 道 業 持 護 長 為 羅 成 車 文 短 函 篁 面 明 美 慶 書 史 仙 纂 竹 治 船 蓋 浚 廟 起 水 武 
鴉=片 
曲=折 藝 子 線 調 牌 解 直 江 水 尺 庫 譜 ? 目 奇 式 酒 菌 名 風 面 阜 筆 柄 劇 靖 徑 霉 壇 軸 種 笛 度 卷 流 率 繞 沃 陽 
瘋=子 狂 病 人 狗 跑 掉 了 癲 話 魔 玩 長 女 杈 
燦=爛 然 亮 
脫=離 身 落 稿 手 出 逃 節 俗 險 皮 脂 發 誤 貧 軌 氧 去 下 衣 鉤 了 水 罪 粒 掉 毛 光 色 困 銷 鞋 漏 硫 靶 班 產 除 黨 檔 毒 貨 崗 肛 膠 臼 骱 機 韁 口 殼 空 盲 帽 坯 坡 期 氫 澀 兔 胎 位 鹽 羽 開 泡 碳 穎 
瓜=子 分 果 葛 仁 類 片 農 瓤 代 蔓 皮 棚 期 秧 藤 田 
奔=走 流 馳 騰 跑 赴 涌 波 忙 喪 雷 命 向 放 跳 襲 頭 去 出 勞 竄 駛 逝 逃 突 瀉 逐 回 馬 月 
嬰=兒 孩 
艱=難 苦 巨 深 辛 險 澀 危 困 
厭=惡 倦 煩 棄 了 世 食 膩 恨 學 氧 戰 氣 
官=僚 吏 員 場 司 兵 話 方 職 府 銜 廳 能 事 腔 商 邸 氣 階 名 軍 紳 紗 印 報 價 房 渡 差 癮 倒 地 長 位 辦 了 人 了 稱 道 費 宦 服 家 爵 迷 派 署 屬 書 運 窯 衙 佐 制 兒 田 學 
葡=萄 文 
尚=未 書 且 武 有 在 待 可 早 無 存 屬 需 欠 能 不 須 志 好 饗 難 感 淺 義 
搗=亂 鬼 蛋 毀 鼓 碎 藥 爛 
鑰=匙 
偵=探 察 緝 查 破 測 辦 訊 聽 獲 結 
隱=藏 約 士 瞞 蔽 居 秘 痛 晦 諱 語 沒 匿 現 伏 憂 衷 情 私 形 患 疾 含 性 密 身 喻 去 然 退 忍 避 遁 睪 僻 射 血 逸 映 
片=子 刻 段 斷 兒 面 中 名 長 酬 商 頭 時 約 尾 狀 劑 花 警 基 言 巖 門 盤 語 
插=嘴 圖 畫 入 花 曲 口 隊 足 話 手 銷 滿 排 秧 頭 班 屏 槽 座 在 上 件 進 卡 柳 拔 播 冊 床 戴 定 管 架 腳 空 瓶 身 穗 條 敘 頁 言 翅 到 接 孔 栓 于 字 
企=圖 業 盼 望 求 鵝 劃 及 管 慕 
塵=土 埃 垢 寰 沙 世 俗 囂 封 慮 坌 暴 毒 肺 芥 事 霧 緣 煙 海 
閱=讀 歷 兵 覽 報 卷 辦 批 世 看 悉 
擁=護 抱 擠 有 戴 躉 吻 立 堵 軍 進 塞 兵 到 入 
河=南 水 岸 北 流 面 灘 道 山 堤 畔 身 床 套 內 口 溝 豚 泥 灣 源 渠 魚 壩 馬 川 港 谷 柳 神 蟹 邊 上 中 里 西 段 東 貍 ? 蚌 槽 池 汊 底 防 漢 工 干 麂 間 曲 塘 鮮 心 系 沿 運 涌 濱 伯 津 洛 蝦 
荒=唐 涼 謬 山 野 蕪 島 廢 原 誕 漠 草 淫 村 地 郊 僻 年 亂 疏 灘 丘 坡 落 寒 古 寂 瘠 蠻 棄 歉 沙 數 信 政 冢 置 
怪=物 事 人 異 話 僻 味 罪 癖 論 招 笑 聲 誰 胎 象 獸 誕 我 杰 談 他 你 哉 病 客 石 不 才 道 的 譎 圈 怨 樣 叫 臉 了 態 相 想 
拜=訪 年 壽 托 見 會 望 倒 師 讀 佛 領 仁 認 別 辭 賀 服 金 節 客 盟 求 掃 識 堂 謝 謁 城 請 
蘋=果 
船=只 夫 頭 長 家 主 身 票 艙 舷 員 戶 篷 舶 幫 錢 運 埠 民 工 位 東 隊 體 上 務 的 廠 塢 期 費 尾 齡 次 帆 歌 級 籍 模 艄 首 臺 艇 桅 閘 邊 底 舵 兒 篙 貨 艦 槳 殼 客 名 橋 室 王 型 狀 
謹=慎 防 向 守 記 上 飭 嚴 呈 身 
采=用 取 訪 辦 集 納 摘 購 錄 石 掘 風 礦 伐 種 挖 樣 花 光 編 哦 暖 認 蓮 茶 地 景 煤 買 收 食 寫 擷 信 血 邑 油 擇 制 到 的 蜜 氣 區 藥 撞 
投=降 機 入 資 考 射 身 靠 彈 奔 河 票 向 宿 遞 槍 緣 擲 誠 案 標 敵 井 書 影 放 送 手 訴 稿 注 保 產 下 以 寄 契 進 在 球 胎 映 到 中 合 籃 出 料 筆 毒 繯 壺 簧 海 工 軍 江 拍 親 師 生 喂 效 醫 藥 足 環 回 來 棄 石 水 梭 
爆=發 竹 炸 裂 破 炒 彈 出 滿 料 冷 笑 棚 燃 機 胎 仗 肚 開 
渴=望 求 念 慕 想 盼 的 著 
救=國 命 濟 人 火 急 星 活 護 助 治 兵 援 災 生 主 贖 市 出 回 世 起 亡 你 難 場 荒 駕 險 應 藥 球 
薪=水 金 俸 資 餉 酬 火 
貨=物 色 車 幣 船 攤 郎 價 架 棧 品 艙 柜 輪 場 單 款 箱 運 倉 源 主 票 機 流 店 損 聲 梯 位 樣 殖 簽 載 
略=帶 微 為 去 同 談 遜 表 語 圖 讀 說 有 作 述 嫌 加 過 長 高 顯 懂 大 論 稱 知 差 記 具 施 小 陽 
伯=母 父 樂 仲 恩 爵 公 勞 祖 
阻=止 礙 力 攔 撓 擋 隔 塞 截 擾 滯 斷 抗 遏 難 尼 燃 梗 擊 絕 援 值 
折=磨 回 扣 斷 騰 疊 扇 子 中 合 服 戟 返 光 算 價 舊 射 讓 紙 起 腰 椅 辱 本 秤 半 變 尺 沖 兌 刀 福 干 桂 傘 壽 受 損 殺 頭 線 頁 賬 皺 轉 層 成 抵 痕 角 彎 帳 褶 
圣=人 經 賢 母 潔 旨 地 上 廟 手 水 子 僧 域 藥 餐 誕 靈 殿 體 堂 者 徒 詩 火 職 像 典 城 戰 女 禮 歌 主 壇 君 明 品 訓 諭 哲 杯 代 所 言 約 俸 
挨=著 打 餓 罵 近 揍 次 過 凍 個 整 了 邊 斗 罰 擠 肩 靠 批 宰 門 刀 到 戶 家 
喇=叭 嘛 蛄 
燒=餅 香 酒 著 毀 火 紙 雞 賣 壞 煮 身 起 到 鍋 料 傷 烤 炭 錄 死 盡 焦 掉 了 的 成 過 毛 焊 堿 飯 制 包 杯 柴 瓷 荒 化 結 麥 瓶 錢 水 心 灼 磚 菜 出 穿 光 棄 窯 
田=地 野 園 間 產 畝 雞 埂 壟 主 螺 邊 舍 賦 莊 鼠 徑 中 原 里 聯 獵 亮 疇 塍 父 畈 坎 岷 契 七 賽 壇 頭 協 震 單 肚 糧 
靠=近 山 背 岸 邊 攏 手 枕 墊 著 的 在 你 他 我 上 前 后 旗 椅 準 窗 港 海  水 
顧=慮 忌 客 問 及 全 惜 主 念 委 家 憐 臉 戀 眄 盼 繡 敻 ? 城 
螞=蟻 蚱 蟥 螂 蝗 
坦=白 克 率 誠 蕩 途 言 然 承 陳 緩 實 直 
愚=蠢 笨 昧 民 弄 蒙 陋 拙 魯 頑 妄 懦 人 見 鈍 兄 忠 公 勇 
構=成 造 思 圖 想 筑 建 件 模 陷 架 擬 詞 型 象 怨 形 
敬=愛 意 禮 重 佩 畏 酒 仰 語 慕 請 獻 業 辭 贈 老 奉 上 之 稱 賀 候 服 告 括 頌 挽 羨 香 信 煙 祝 神 
衛=生 兵 隊 士 戍 星 視 理 冕 護 國 校 浴 道 報 青 璧 東 輝 
傍=晚 黑 姐 明 晌 水 午 依 邊 
養=成 活 病 家 女 育 老 神 料 分 子 兵 母 父 身 馬 傷 護 路 的 生 殖 魚 人 大 顏 性 豬 氣 心 雞 廉 綠 蠶 畜 地 花 蜂 漢 ? 息 眼 肥 鳥 牛 
雞=蛋 毛 湯 肋 頭 心 雛 冠 肉 眼 爪 血 翅 舍 胸 雜 鴨 鳴 棚 籠 公 腿 西 巴 柳 丁 奸 精 窩 瘟 子 肫 東 年 啼 柵 
邏=輯 
皺=眉 紋 痕 褶 起 襞 胃 邊 縮 摺 
茫=然 然 昧 
響=亮 聲 應 動 器 鈴 著 箭 起 徹 遍 度 雷 兒 鑼 鼻 板 鞭 馬 晴 槍 頭 音 指 水 
巧=妙 合 事 計 匠 遇 手 干 學 辯 勁 思 言 用 答 逢 婦 取 戰 
竟=然 自 是 有 能 會 成 要 敢 日 連 達 而 購 未 夜 至 址 
辭=職 去 別 行 典 退 源 藻 令 海 歲 呈 賦 書 章 色 世 句 讓 任 靈 費 活 工 官 聘 卻 謝 
落=后 淚 地 日 花 葉 伍 水 成 空 筆 腳 入 難 實 座 選 戶 款 網 馬 雁 霞 滿 下 拓 榜 幕 體 在 敗 案 到 下 得 單 雨 山 寞 差 發 第 潮 點 定 忍 雷 魄 標 膘 泊 槽 草 塵 槌 底 ? 黑 荒 果 谷 價 架 籍 價 炕 墨 魄 聘 色 生 市 鎖 套 鄉 雪 音 英 枕 子 賬 照 錘 紅 進 首 桃 
盤=算 子 旋 問 踞 桓 古 纏 剝 繞 查 里 點 道 貨 面 整 中 劃 庫 亙 片 山 弄 存 秤 川 錯 店 跌 底 符 費 活 根 結 詰 錦 繳 究 曲 升 腿 梯 陀 條 頭 膝 香 鷹 運 賬 坐 帶 盈 
詞=匯 句 兒 人 曲 典 話 語 調 鋒 眼 霸 義 譜 法 牌 訟 表 尾 韻 源 組 的 庫 類 頻 條 序 根 干 素 頭 性 形 選 余 綴 曰 首 宗 
估=計 量 價 算 摸 產 測 評 衣 定 
暑=假 期 天 熱 氣 瘟 夏 運 
度=過 日 量 假 數 身 牒 命 曲 汛 荒 人 
壞=人 事 處 話 蛋 書 死 的 了 賬 的 水 道 掉 球 透 種 
弱=點 者 小 國 質 于 氣 得 項 智 勢 的 視 化 旅 女 電 冠 堿 酸 隊 光 
拘=束 謹 捕 留 禁 泥 押 控 禮 拿 攣 板 傳 管 審 役 囿 執 
簾=子 櫳 布 幕 
繩=子 索 墨 梯 纜 操 套 頭 帶 圈 
佛=教 經 像 家 法 堂 山 爺 寺 陀 門 手 龕 事 說 塔 學 道 光 殿 祖 典 國 老 燈 號 牙 珠 
堂=屋 上 兄 姐 妹 弟 鼓 主 會 皇 客 奧 房 號 倌 戲 子 
猴=子 兒 年 腦 頭 王 急 拳 戲 
震=動 驚 天 撼 蕩 怒 懾 中 源 災 央 顫 波 駭 感 級 情 區 悚 響 耳 搖 音 
典=型 故 禮 雅 籍 章 范 藏 當 賣 契 押 獄 
洗=澡 刷 衣 手 禮 滌 劫 垢 練 染 凈 頭 碗 面 發 腳 去 臉 錢 脫 車 牌 腦 濯 過 塵 掉 堿 劑 盤 漱 三 涮 雪 選 浴 印 冤 菜 好 煤 清 身 燙 胃 罪 
禿=子 鷲 頭 鷹 驢 嚕 嶺 筆 瘡 頂 瓢 山 
煙=卷 袋 臺 霧 灰 斗 囪 槍 火 土 頭 筒 癮 草 鬼 云 嘴 盒 塵 雨 葉 蒂 霞 波 花 具 煤 絲 缸 柳 子 幕 柱 酒 民 霾 氣 味 靄 農 嵐 販 堿 癖 色 瘴 窗 館 鍋 海 客 酸 熏 
寬=大 闊 容 敞 恕 廣 慰 綽 厚 裕 松 泛 心 舒 限 暢 曠 約 嚴 屏 窄 度 余 頻 的 帶 宏 讓 饒 待 貸 和 幅 軌 解 假 免 赦 狹 衣 宥 展 縱 邊 城 甸 體 
欄=桿 目 柜 柵 板 架 外 位 
迎=接 面 合 頭 春 風 送 擊 戰 候 來 上 敵 新 娶 著 賓 客 親 迓 角 
優=秀 美 待 越 點 良 勢 伶 劣 于 勝 異 裕 等 普 柔 生 先 厚 惠 選 質 雅 化 級 育 派 盤 容 撫 渥 游 遇 種 絮 
珊=瑚 
張=開 羅 望 嘴 揚 貼 狂 口 三 網 榜 弛 軾 
局=面 勢 促 部 限 外 內 級 域 點 麻 騙 長 子 里 座 
儀=式 器 表 仗 容 態 節 征 禮 隴 
補=充 救 習 助 足 償 課 藥 遺 考 缺 貼 白 品 丁 闕 貨 票 益 報 血 發 給 臺 養 選 牙 上 領 倉 交 假 腎 了 氣 漏 編 辦 碼 全 入 腦 課 差 裰 訂 回 花 過 劑 角 苴 酒 苗 齊 射 時 稅 色 休 寫 語 液 妝 正 綴 種 鍋 繳 空 零 數 題 圖 位 校 鞋 修 
傻=子 瓜 氣 笑 事 話 勁 干 冒 妞 站 的 了 人 屄 樣 樂 蛋 帽 眼 
怒=氣 吼 火 容 潮 罵 視 放 濤 色 道 了 斥 族 目 海 叱 號 喝 江 毆 意 
擺=脫 設 動 布 弄 手 渡 攤 闊 酒 譜 放 鐘 在 出 明 上 賣 了 滿 平 到 著 好 下 列 手 劃 功 件 開 拍 臺 線 宴 正 治 桌 子 錘 法 進 來 起 去 
幼=稚 年 兒 小 子 苗 女 童 芽 蟲 果 林 雛 功 教 體 嫩 師 時 犬 獅 弱 齡 畜 虎 株 根 駒 君 木 禽 獸 樹 
胸=脯 口 膛 部 襟 懷 臆 腔 無 像 骨 鰭 章 前 圍 中 透  腹 悶 肌 痛 卡 椎 花 徑 廓 膜 腺 罩 痹 甲 內 片 飾 衣 針 
軟=弱 化 的 緞 木 和 墊 禁 骨 式 皮 件 片 席 玉 食 梯 座 硬 的 性 語 盤 碟 尺 驅 ? 床 蛋 風 話 膏 管 接 磨 水 糖 臥 線 脂 泥 肋 材 飯 鋼 瘤 毛 體 
捉=住 摸 弄 拿 到 蟲 賊 對 刀 奸 魚 
豆=腐 子 漿 汁 花 莢 綠 沙 芽 角 餅 瓣 粕 油 包 乳 豉 面 類 奶 蓉 粒 粉 秸 醬 蔻 科 苗 皮 萁 青 薯 渣 豬 莖 象 
野=蠻 心 獸 草 花 外 雞 豬 地 餐 馬 性 人 史 貓 菜 景 牛 火 味 生 兔 鴨 果 鳥 合 放 物 戰 鴿 驢 禽 鼠 營 種 的 蜂 狗 鬼 炊 菊 趣 宴 游 渡 柳 炮 球 
較=為 之 量 真 大 高 早 低 多 少 佳 長 好 易 小 差 強 快 難 短 前 弱 有 慢 上 輕 后 具 深 新 遠 細 能 廣 優 近 勁 比 壞 晚 寬 硬 粗 窄 緊 重 著 
恭=維 敬 喜 候 順 賀 祝 請 謹 迎 聽 
柱=子 石 頭 腳 狀 礎 廊 面 塞 身 體 
恨=死 得 事 我 不 人 透 極 意 
克=服 制 扣 難 魯 隆 里 勤 星 拉 己 萊 爾 朗 日 拉 復 敵 東 儉 倫 強 山 
瞧=見 這 去 那 一 
呻=吟 
拿=下 手 開 點 獲 著 出 起 到 來 去 走 的 回 錢 給 捏 騷 住 掉 過 大 上 人 辦 頂 牌 喬 權 糖 筆 刀 事 藥 
逝=世 水 去 
哎=呀 喲 唷 
藤=椅 蘿 子 條 箱 牌 黃 編 球 器 蔓 鞭 架 莖 筐 
監=獄 督 視 牢 禁 察 工 護 管 軍 守 制 考 控 測 理 事 查 房 委 聽 裝 票 場 利 本 國 規 生 押 造 
轟=炸 動 然 擊 雷 響 隆 趕 鳴 聲 走 
扇=子 面 動 車 形 區 貝 骨 墜 出 惑 子 舞 狀 
忠=實 誠 厚 于 告 臣 心 貞 義 良 言 順 魂 信 孝 恕 烈 骨 藎 勇 憤 縣 直 
頗=為 似 能 負 費 大 有 高 多 具 受 佳 感 豐 
導=演 師 致 游 言 碼 向 報 電 論 線 彈 航 引 入 購 管 板 輪 出 體 熱 流 尿 播 標 讀 發 軌 姐 數 揚 語 源 護 通 柱 
某=些 個 部 人 省 女 男 件 一 種 人 項 日 天 地 位 處 年 月 家 事 軍 時 甲 乙 市 物 縣 鄉 
執=行 筆 政 意 法 照 教 掌 著 委 業 著 事 導 勤 一 迷 拗 泥 鞭 爨 紼 友 
柔=和 軟 弱 媚 順 情 嫩 韌 道 術 性 滑 婉 美 潤 腸 風 曼 細 兒 光 化 毛 枝 
欲=望 念 與 求 絕 火 滴 語 去 雨 墜 
釘=子 錘 耙 在 螺 子 帽 是 鞋 合 尖 緊 進 牢 入 頭 住 
切=實 身 斷 合 開 面 磋 忌 當 腹 形 到 題 割 記 片 變 點 除 口 勿 換 成 入 碎 莫 絲 診 去 線 削 塊 紙 齒 分 花 匯 糕 近 脈 末 盼 要 音 中 菜 掉 膚 角 望 細 下 屑 
類=似 書 型 推 別 像 的 目 此 同 比 化 乎 聚 群 次 屬 項 脂 
朝=鮮 廷 著 陽 代 夕 野 霞 氣 露 日 拜 向 見 政 服 暮 后 暉 圣 天 覲 中 上 他 下 臣 頂 賀 奉 綱 貢 山 陽 珠 雨 報 北 東 里 南 前 外 西 旭 宗 
遭=遇 受 到 殃 難 劫 人 逢 災 害 際 罪 
虎=子 狼 口 穴 牙 威 將 皮 勁 豹 門 貓 賁 步 膽 符 伏 鯨 氣 鉗 實 勢 視 嘯 鞭 骨 踞 林 年 尾 仔 
昆=明 蟲 曲 山 腔 騰 劇 侖 布 季 仲 
閃=爍 電 光 耀 動 開 現 客 存 人 失 亮 避 過 出 著 身 念 躲 擊 屏 射 語 族 
勸=告 慰 阻 解 說 誘 導 架 止 和 誡 君 降 勉 善 化 諭 你 返 酒 諫 駕 進 募 退 學 農 業 
炮=火 聲 彈 臺 兵 灰 手 車 制 轟 擊 艦 響 眼 艇 樓 位 仗 烙 煉 銃 打 格 口 釬 塔 膛 筒 衣 竹 戰 管 門 座 
慷=慨 
渺=茫 小 然 
密=切 集 友 布 談 云 令 謀 探 約 林 封 度 告 電 閉 實 件 碼 使 植 的 合 語 宗 技 室 級 信 會 報 商 斯 寫 旨 詔 召 致 訪 接 山 醫 議 鑰 
磕=頭 碰 打 巴 掉 破 
宴=會 席 請 客 爾 樂 飲 饗 
殘=酷 忍 廢 余 暴 殺 月 留 存 骸 疾 害 羹 生 陽 跡 照 年 局 像 念 敵 兵 部 匪 渣 障 舊 品 缺 破 油 敗 聯 虐 本 幣 次 喘 冬 黨 毒 貨 稿 酒 卷 片 棋 秋 損 剩 雪 效 頁 奧 茬 根 荷 壘 夢 日 炭 屑 枝 株 
陳=列 設 腐 舊 述 跡 說 酒 皮 勝 訴 醋 規 明 詞 辭 年 貨 毅 言 兵 沖 好 某 
牛=奶 肉 馬 皮 車 痘 角 排 郎 頓 犢 勁 背 性 仔 黃 筋 虻 氣 頭 油 津 市 羊 扒 尾 腩 酪 瘟 群 耳 棚 屄 莉 乳 欄 刀 肚 糞 倌 毛 圈 舍 蛙 娃 飲 鞅 蠅 人 槽 年 舌 疫 至 軛 
搬=家 進 運 動 弄 屋 遷 兵 到 上 出 走 離 了 來 回 移 掉 用 演 得 的 開 起 下 
虛=偽 假 榮 心 構 名 弱 度 驚 實 線 浮 設 文 字 火 晃 了 卡 汗 禮 套 報 詞 數 歲 擬 空 幻 無 妄 夸 言 的 脫 胖 腫 辭 功 驕 愒 飾 土 像 懸 掩 譽 職 造 癥 擲 竹 根 話 靡 位 頁 應 張 
詢=問 查 
末=了 年 后 尾 日 期 路 流 端 兒 裔 子 座 梢 世 代 席 伏 節 將 位 葉 
屈=原 服 辱 膝 指 就 從 才 居 曲 駕 伸 節 死 枉 戌 尊 身 折 
杯=子 水 賽 葛 中 盞 內 
超=過 越 出 脫 級 常 生 度 額 驗 星 酷 任 爽 多 快 版 編 車 支 重 人 值 市 時 乎 卓 速 強 前 高 標 大 然 凡 頻 期 員 載 群 絕 齡 假 長 勝 女 量 拔 產 采 導 等 好 耗 敢 購 集 收 聲 升 俗 限 逸 子 薄 點 軸 
訂=婚 正 立 閱 好 購 戶 約 貨 定 明 單 票 造 下 出 于 價 金 為 做 座 費 數 書 報 交 親 餐 
舊=式 時 書 詩 日 歷 事 貨 學 情 居 俗 觀 聞 址 物 習 都 地 宅 交 病 話 制 案 國 故 的 約 有 作 區 版 愛 款 車 貌 人 城 衣 夢 部 稱 業 友 惡 例 好 家 教 跡 識 損 體 套 雨 章 知 賬 幣 船 房 債 
饅=頭 
櫻=花 桃 樹 草 唇 
槍=斃 聲 炮 彈 口 殺 決 械 桿 手 法 擊 支 眼 響 案 托 戰 傷 崩 刺 管 栓 術 替 膛 魚 靶 兵 柄 機 架 身 套 子 
桃=花 子 李 樹 色 林 仁 汛 園 紅 源 符 脯 酥 江 
誘=惑 人 導 拐 殺 發 奸 騙 因 餌 使 降 供 捕 變 逼 敵 迫 脅 掖 引 致 出 陷 
埃=及 
凳=子 
鑼=鼓 聲 
謙=虛 遜 讓 卑 恭 和 辭 稱 誠 順 詞 
亭=子 內 臺 午 
陰=暗 影 謀 歷 沉 天 險 郁 森 雨 云 涼 霾 私 風 溝 冷 騭 毒 功 魂 曹 德 電 道 爻 角 跌 性 干 戶 部 極 門 平 陽 莖 間 晴 囊 氣 柔 唇 核 的 狠 晦 面 毛 損 壽 司 山 濕 文 線 虛 笑 韻 鷙 宅 慘 蒂 阜 模 虱 穴 
蘿=卜 北 匐 
梅=花 林 雨 毒 子 香 樹 西 州 縣 婷 村 杰 嶺 斯 塔 園 
夸=獎 張 大 贊 耀 口 誕 克 示 飾 說 脫 嘴 父 
懇=切 求 摯 請 辭 談 托 望 
迅=速 捷 馳 即 猛 雷 步 疾 急 
憔=悴 
配=合 備 角 給 偶 置 搭 藥 對 色 圖 好 方 音 制 樂 料 飾 套 種 屬 件 售 額 上 股 戴 有 電 發 送 器 成 比 餐 唱 稱 殿 房 火 購 軍 平 曲 膳 伍 戲 享 演 子 載 型 菜 齊 
墳=墓 地 頭 山 塋 丘 場 包 堆 冢 
吶=喊 
搜=集 索 尋 查 羅 刮 捕 霸 游 身 出 狐 狗 繳 剿 檢 救 括 摸 察 求 
紙=條 張 煙 片 錢 牌 盒 花 幣 捻 屑 船 鳶 傘 版 馬 票 箱 型 板 帶 漿 上 巾 業 包 袋 杯 樣 廠 面 灰 封 夾 繩 頭 匣 鷂 扎 背 鶴 卷 簍 鎮 
系=統 列 著 好 數 在 指 辭 念 詞 縛 譜 上 于 子 泊 帶 花 緊 牢 鏈 了 繩 
亞=洲 當 細 麻 軍 太 視 運 裔 倫 斯 伯 歐 非 于 種 胺 丁 東 綱 光 聯 氯 瑟 鐵 銅 
旋=轉 風 律 即 子 開 鈕 繞 紐 流 回 塞 梯 舞 翼 鑿 緊 進 踵 
歲=月 數 末 序 晚 出 入 首 差 初 除 暮 杪 收 尾 星 修 
縣=城 官 份 委 志 市 級 辦 區 域 立 直 令 內 府 界 屬 衙 長 治 政 里 鄉 丞 
柜=臺 子 面 櫥 門 房 上 員 中 
望=見 月 族 著 你 去 到 遠 天 樓 日 板 穿 斷 風 門 天 磚 子 診 城 江 奎 
占=據 領 有 用 先 卜 滿 個 夸 地 星 了 優 去 居 到 營 理 卦 課 夢 位 線 壓 住 得 
拋=棄 擲 錨 售 向 入 妻 進 到 灑 出 臉 離 餅 荒 費 光 盤 卻 球 射 舍 撒 掉 開 空 起 投 下 
匣=子 
濃=厚 郁 密 黑 淡 度 縮 烈 情 煙 的 霧 重 妝 綠 茶 眉 墨 香 艷 陰 云 霜 湯 液 
尖=銳 利 兒 刀 端 頭 刻 頂 兵 酸 音 子 瘦 山 角 石 叫 的 嘴 峰 厲 脆 嘯 牙 刺 臍 峭 聲 塔 細 削 
店=員 鋪 主 堂 家 內 里 中 面 東 名 前 門 伙 風 貌 址 長 
袍=子 哥 澤 
兔=子 年 唇 毫 毛 脯 脫 
乾=隆 坤 宅 安 縣 
云=南 霧 彩 海 雀 霞 氣 層 煙 端 霄 游 集 梯 翳 天 母 錦 朵 頂 鬢 鑼 團 間 吞 漢 林 景 浮 山 龍 散 雨 手 量 霓 板 豹 帶 鬟 貴 際 杉 圖 頭 濤 涌 狀 峰 門 水 中 玲 淡 和 嶺 夢 臺 陽 英 影 
排=列 場 斥 演 隊 印 除 擠 行 泄 練 字 解 骨 定 頭 比 前 課 布 球 放 槍 尾 版 律 偶 氣 筆 炮 水 名 出 在 污 序 毒 入 位 灌 澇 到 好 外 成 他 上 汗 尿 便 齊 開 遣 卵 長 雷 班 查 擋 檔 洪 華 筏 號 管 擊 檢 空 壇 險 戲 簫 椅 架 異 憂 
化=為 學 裝 身 妝 作 名 石 解 工 驗 合 用 蝶 凍 肥 境 成 纖 之 有 療 碳 痰 硫 氮 做 開 外 膿 除 募 食 形 緣 育 淤 齋 轉 氨 鋇 碘 鈣 鉀 簡 磷 鋁 鎂 錳 鈉 鉛 鐵 銅 性 州 鉍 鋰 
區=別 域 分 委 外 市 間 內 旗 徽 位 縣 劃 號 碼 段 隊 府 塊 屬 長 星 級 鄉 
初=次 期 版 中 步 學 見 夏 五 稿 級 戀 春 六 八 三 十 九 四 衷 小 七 試 犯 婚 創 交 等 伏 選 雪 戰 時 階 出 生 賽 探 始 段 到 二 一 年 開 來 審 現 吻 會 露 具 夜 識 度 顯 潮 冬 虧 民 評 秋 晴 霜 速 歲 升 心 旬 葉 愿 月 綻 診 值 訪 乳 血 裝 
掩=飾 護 蓋 映 藏 蔽 埋 口 體 鼻 閉 殺 襲 理 碼 
卻=說 步 不 是 又 有 在 被 要 沒 能 對 也 可 仍 只 無 會 與 給 使 比 將 成 讓 更 連 怕 再 病 敵 
視=為 線 察 覺 野 聽 角 力 圖 乎 作 訊 之 學 同 頻 點 窗 如 唱 域 界 弱 差 距 盤 事 屏 區 錐 
緞=子 紋 帶 木 
威=風 脅 嚴 力 權 武 信 嚇 儀 勢 名 逼 望 盛 懾 廉 爾 猛 海 迫 剛 赫 震 壓 遠 
吆=喝 呼 
阿=囡 媽 姨 哥 斗 牛 嚏 婆 膠 爸 飛 妹 曼 里 伯 寶 拉 諾 公 門 達 蓮 杜 朵 爹 混 虎 附 盟 嫂 嬸 諛 雅 
嫌=疑 棄 少 多 話 隙 犯 惡 煩 怨 憎 大 
嘈=雜 
料=到 理 子 想 庫 酒 中 車 定 斗 及 峭 器 事 
摩=登 托 擦 挲 羯 尼 根 西 爾 天 絲 崖 撫 
拉=開 扯 手 攏 長 丁 雜 薩 響 琴 康 登 平 鏈 稀 鋸 鎖 近 著 動 力 的 票 美 出 上 到 起 傷 下 住 了 面 高 回 幅 客 緊 夫 床 人 我 直 去 走 巴 進 隊 入 練 車 倒 祜 貨 風 鉤 桿 纖 伸 絲 套 網 線 秧 運 一 閘 賬 德 掉 斷 管 花 環 架 腳 裂 磨 繩 屎 延 制 孜 
凝=視 神 望 眸 結 固 聚 思 滯 集 藥 脂 重 膠 練 碧 成 凍 定 合 華 目 想 注 乳 縮 血 
詛=咒 罵 
翅=膀 子 果 脈 翼 鞘 
束=縛 帶 腰 發 身 手 裝 腹 緊 狀 
乞=丐 憐 討 求 靈 援 兒 食 降 巧 
漫=畫 游 長 步 天 談 山 迷 過 延 話 兒 流 筆 道 灌 卷 記 坡 射 說 溢 語 
燃=燒 起 放 料 燈 點 油 氣 煤 素 耗 眉 盡 著 
式=樣 子 微 送 
蠟=燭 臺 人 炬 紙 黃 染 板 版 筆 像 床 花 果 丸 油 布 膏 療 質 嘴 
爹=媽 娘 
柳=樹 條 州 絮 眉 營 蔭 下 青 綠 江 絲 琴 編 笛 罐 綿 木 腔 杉 體 腰 葉 鶯 枝 子 河 林 梢 
鴿=子 房 哨 派 翼 
喊=叫 聲 話 著 冤 出 過 打 價 好 起 醒 
紫=色 檀 藤 荊 銅 薇 貂 苑 黑 龍 菜 竹 草 紅 微 砂 光 川 癜 花 杉 ? 菀 毫 
志=愿 氣 士 向 趣 偉 在 成 堅 誠 行 異 哀 子 丹 峰 民 
憲=兵 法 政 章 報 制 警 
吵=鬧 架 嘴 嚷 完 死 醒 擾 人 罵 
零=碎 星 錢 落 用 亂 食 件 散 頭 花 下 賣 點 售 嘴 度 吃 兒 工 活 蛋 位 時 的 分 陵 料 擔 買 票 數 上 訊 型 字 
渡=船 過 口 頭 輪 槽 海 河 邊 江 橋 鴉 
獻=給 身 花 禮 策 詞 技 映 計 藝 上 出 辭 金 血 寶 丑 媚 旗 芹 演 酒 縣 
憐=憫 惜 恤 愛 
搭=訕 救 理 橋 伙 配 腔 乘 檔 頭 建 上 車 機 棚 載 起 成 船 鏈 伴 班 幫 背 便 補 茬 話 鉤 蓋 界 客 扣 售 設 識 手 臺 線 腰 出 錯 好 架 
食=物 指 糧 堂 品 欲 客 宿 譜 量 言 用 管 鹽 道 素 糖 具 性 肆 療 肉 人 槽 油 街 餌 料 補 分 口 甚 相 櫥 醋 盒 貨 積 籃 糜 寢 
憎=惡 恨 稱 厭 
給=予 以 水 定 足 與 養 我 你 他 人 了 她 您 出 假 它 誰 付 分 錢 點 臉 付 水 
王=子 后 八 府 公 朝 爺 道 宮 國 室 妃 法 侯 孫 冠 位 族 牌 儲 者 維 權 成 平 朔 
綢=緞 子 條 布 帶 繆 
姥=爺 
圓=滿 桌 圈 形 通 滑 潤 熟 球 柱 子 場 錐 臺 周 筒 寂 臉 心 規 弧 籠 成 的 夢 型 點 頂 渾 環 山 領 雕 號 房 謊 墳 光 鋼 盤 全 實 鐵 月 真 餅 角 徑 木 丘 石 的 鑿 睜 珠 銼 
松=樹 林 柏 懈 弛 開 手 鼠 木 子 軟 散 動 濤 花 針 明 快 口 香 勁 竹 解 脆 緊 煙 氣 脫 綁 下 山 仁 蘿 包 緩 果 江 雞 蘑  球 土 閑 心 蕈 脂 嘴 枝 餅 的 扣 類 溪 陽 魚 滋 
牌=子 樓 坊 位 號 匾 類 照 局 價 兒 九 技 迷 面 示 手 證 點 桌 
酒=杯 席 館 菜 店 后 飯 意 量 壺 精 樓 錢 食 家 窩 盅 徒 缸 會 令 吧 鬼 釀 色 糟 宴 柜 坊 器 具 泉 類 醉 水 瓶 廠 香 氣 保 齡 力 簾 甏 池 花 工 漿 客 旗 肆 壇 望 渦 味 甕 興 仙 醒 藥 靨 肴 友 筵 盞 石 話 窖 女 曲 商 神 湯 桶 椰 質 癮 
鉛=筆 字 粉 絲 球 印 版 油 芯 礦 錘 封 灰 華 條 直 板 丹 膏 塊 色 山 制 
菊=花 科 石 壇 劍 豆 芋 展 
棉=花 襖 被 衣 褲 紗 絮 線 布 田 桃 套 紡 質 農 蘭 籽 鈴 餅 猴 毛 袍 簽 球 區 毯 鞋 織 堆 卷 絨 條 蚜 紙 珠 
雕=刻 塑 像 花 琢 龍 蟲 鑿 漆 鏤 版 鐫 砌 飾 成 鑄 
飲=食 酒 水 料 用 服 品 茶 恨 宴 泣 場 彈 馬 片 譽 子 
拍=手 打 子 賣 攝 照 板 手 拖 得 出 成 戲 片 掌 完 磚 案 岸 檔 定 發 花 撫 價 擊 馬 球 動 
淺=薄 顯 水 陋 近 灘 見 議 說 易 露 海 談 白 的 藍 色 析 釋 的 黃 笑 嘗 綠 淡 化 灰 紅 耕 明 山 學 子 棕 紫 表 層 碟 盤 箱 
驀=地 然 
間=或 接 隔 斷 諜 作 歇 雜 隙 架 的 苗 距 層 色 量 腦 壁 道 伐 種 質 
胭=脂 紅 
屢=次 有 受 試 經 犯 獲 創 遭 
傭=人 工 錢 金 兵 
屠=殺 戶 夫 宰 刀 龍 城 戮 
律=師 詩 考 法 動 己 令 呂 條 宗 
喪=事 失 氣 禮 命 葬 偶 鐘 尸 生 服 假 膽 志 父 亂 夫 家 母 妻 權 身 亡 
朗=誦 讀 科 潤 訊 聲 生 伯 扇 照 
質=問 量 樸 地 料 疑 控 監 點 感 詢 變 素 的 保 數 押 檢 對 子 證 權 體 心 言 
泥=土 人 濘 鰍 塘 漿 沙 金 水 塑 潭 巴 沼 垢 胎 坑 丸 灘 煤 淖 療 肥 封 工 古  炭 腿 污 洼 巖 雨 牛 流 地 灰 腳 塊 磚 
擋=住 駕 路 在 風 板 車 得 寒 子 道 開  雨 
耶=穌 律 魯 誕 
裙=子 釵 帶 服 褲 裝 
杜=甫 鵑 衡 撰 絕 比 威 家 邦 牧 梨 斌 康 馬 宇 仲 松 
亡=國 故 魂 命 靈 夫 人 妻 失 父 
縱=然 橫 使 容 談 深 令 情 火 隊 觀 的 列 切 飲 軸 膈 馬 貫 向 覽 步 隔 有 身 論 波 酒 目 聲 欲 
揚=州 言 名 棄 帆 威 起 眉 鞭 長 塵 手 
淚=珠 水 痕 眼 花 下 腺 液 光 人 雨 滴 
膀=子 胱 臂 
薄=弱 霧 冰 餅 片 紙 膜 情 荷 的 煙 利 的 紗 田 禮 板 壁 被 脆 產 地 待 厚 海 酒 技 命 面 暮 幸 葬 的 層 酬 皮 衫 云 
饑=餓 荒 渴 寒 民 饉 餒 腸 色 
爽=快 朗 直 性 利 口 呆 不 啊 歪 然 了 脆 塏 目 氣 身 神 死 心 約 
湊=巧 合 近 足 集 手 數 字 成 了 亂 攏 出 到 對 個 夠 錢 趣 齊 上 興 
殷=勤 實 切 紅 鑒 墟 商 離 富 紅 桃 憂 
示=威 意 眾 弱 范 例 愛 人 警 好 教 
票=子 房 號 價 根 額 據 箱 面 證 數 選 源 券 車 匯 匭 款 友 莊 戲 
恥=辱 笑 骨 
槐=樹 蠶 豆 花 角 
哆=嗦 
操=心 場 作 縱 持 勞 練 演 守 行 辦 切 典 神 控 刀 盤 屄 觚 琴 舵 法 起 
繁=榮 華 星 花 殖 多 重 密 盛 復 瑣 雜 忙 衍 茂 難 縟 博 麗 體 簡 育 亂 鬧 冗 本 富 蕪 昌 文 峙 
款=子 待 項 式 留 額 兒 娘 女 步 冬 姐 洽 曲 物 型 爺 客 目 宴 
催=促 眠 逼 生 命 化 肥 吐 芽 情 迫 奶 人 淚 辦 產 動 發 還 告 耕 繳 款 馬 熟 收 討 他 債 著 征 租 青 
蓮=花 子 蓬 池 藕 菜 房 臺 心 宗 座 荷 
康=熙 健 復 樂 橋 寧 柏 泰 德 寶 莊 保 定 華 衢 迪 佳 舞 馬 平 威 
跪=下 拜 倒 求 地 射 墊 著 姿 
繡=花 球 像 房 出 鞋 工 品 制 樓 
納=悶 稅 入 涼 粹 蘭 為 米 卡 彩 罕 福 賄 貢 諫 降 聘 妾 什 新 秒 西 溪 賢 雍 
賭=氣 博 咒 錢 場 徒 具 注 局 圣 球 本 棍 城 馬 債 窟 風 客 鬼 賽 誓 窩 癮 一 資 金 輸 物 賬 桌 
粉=碎 紅 筆 飾 刺 刷 白 末 色 撲 條 嫩 蝶 妝 面 絲 狀 底 彩 盒 塵 黛 腸 坊 劑 餃 墨 皮  沙 板 蛾 煤 沫 
鞋=子 襪 帽 帶 匠 幫 柜 樣 油 類 底 業 店 面 廠 墊 粉 跟 刷 扣 里 頭 
遺=產 憾 傳 留 老 棄 跡 忘 體 囑 失 民 物 像 書 風 漏 言 事 少 容 址 著 恨 稿 骸 聞 珠 愿 志 教 孀 作 訓 孤 詔 照 毒 缺 族 屬 腹 落 精 尿 存 患 禍 骨 墨 篇 矢 業 贈 蹤 從 
埋=怨 頭 葬 伏 藏 沒 雷 在 首 下 單 堆 入 名 設 汰 置 
嗜=好 睡 欲 酒 血 
狡=猾 詐 黠 獪 賴 辯 譎 
耐=心 性 勞 久 寒 聽 曬 饑 熱 用 力 堿 磨 火 穿 煩 旱 看 苦 酸 受 戰 克 綸 壓 藥 震 
涼=風 水 臺 快 爽 氣 亭 棚 席 鞋 粉 菜 透 碟 藥 的 州 茶 拌 意 帽 面 山 薯 枕 片 城 
閨=女 秀 房 中 閣 閫 門 怨 
犯=人 罪 法 病 愁 忌 禁 規 暈 疑 戒 了 案 錯 下 上 有 事 過 難 ? 諱 渾 急 境 賤 困 科 傻 顏 
藏=書 族 身 匿 青 香 品 戲 在 著 經 起 歷 藍 躲 富 鋒 ? 奸 掖 拙 蹤 胞 民 品 文 學 醫 語 藥 寶 獨 量 人 
螃=蟹 
妨=礙 害 
油=燈 條 漆 畫 膩 水 光 坊 滑 船 漬 布 子 紙 雞 亮 污 礦 泥 菜 氣 松 煙 嘴 灰 門 墨 鍋 廠 桶 脂 餅 井 田 香 彩 茶 垢 類 麥 箱 黑 桐 罐 庫 路 盤 區 裙 渣 棕 價 的 壓 性 車 輪 炸 閥 孔 氈 料 泵 印 然 簍 綠 潤 螺 駁 爆 層 荒 耗 花 管 工 膏 港 鋸 毛 苗 皮 瓶 石 飾 酥 刷 鞋 的 藏 質 槽 尺 房 壺 跡 煎 酸 桃 液 盞 
寒=冷 風 暄 氣 噤 磣 酸 心 暑 光 夜 士 流 苦 意 冬 熱 舍 衣 鴉 戰 煙 武 濕 冰 門 帶 露 色 微 蟬 假 潮 窗 傖 秋 峭 山 食 素 腿 星 邪 顫 癥 泉 霜 天 鴨 
甜=蜜 美 味 頭 酒 香 水 菜 食 瓜 棗 品 的 心 點 酸 潤 橙 椒 醬 爽 睡 餅 膩 
賺=錢 頭 足 回 點 取 了 得 到 
糾=紛 纏 正 葛 察 集 偏 結 錯 扯 合 風 舉 
脆=弱 薄 骨 皮 的 嫩 亮 餅 快 生 爽 性 響 棗 點 
述=說 評 職 要 廉 懷 詞 語 
宰=相 割 殺 制 客 
業=已 務 余 績 經 主 大 師 障 界 內 者 外 報 海 態 戶 
蜜=蜂 月 餞 棗 柑 糖 桃 汁 罐 橘 色 甜 丸 腺 源 蠟 露 熊 意 
膝=蓋 頭 部 上 下 糕 行 
掠=過 奪 影 美 取 視 
退=回 出 休 還 后 讓 步 縮 卻 避 化 位 伍 職 席 守 學 潮 色 兵 路 意 給 稿 敗 役 場 堂 換 伙 貨 市 款 的 票 稅 而 下 到 居 燒 去 房 隱 租 格 耕 熱 離 磁 訂 黨 掉 佃 婚 火 股 崗 賠 坡 親 錢 庭 團 行 押 養 走 贓 保 朝 過 漿 開 入 
忙=碌 亂 于 活 死 著 的 得 乎 吧 些 人 叨 音 月 
邀=請 集 約 寵 功 擊 買 
華=人 北 麗 僑 蓋 美 夏 山 南 貴 工 語 中 燈 沙 東 表 陽 師 榮 服 裔 章 潤 府 文 西 商 埠 航 新 碩 納 通 寶 嚴 廈 安 生 氏 誕 興 年 里 彩 發 翰 軍 陰 約 胄 族 寧 坪 清 容 飾 騰 亭 為 屋 宇 鎣 
樸=素 實 散 直 陋 刀 厚 茂 樹 學 質 拙 
界=限 線 石 碑 尺 河 定 別 面 內 說 樁 標 山 域 約 址 外 
剝=削 奪 落 蝕 皮 去 光 離 脫 啄 除 掉 開 殼 下 
蚊=子 帳 蟲 香 蠅 叮 
懺=悔 
楊=柳 樹 梅 家 過 
惋=惜 嘆 
珠=子 寶 翠 算 江 璣 蘭 海 蚌 光 ? 簾 峰 花 影 兒 母 飾 芽 
擠=出 兌 壓 迫 滿 在 進 榨 撞 到 對 干 改 軋 眼 占 軋 車 掉 過 垮 奶 乳 入 上 痛 推 
頑=固 皮 強 童 民 鈍 抗 敵 癥 劣 石 匪 梗 疾 健 軍 癬 
鍛=煉 件 造 錘 打 工 鐵 壓 接 爐 模 燒 子 
窩=頭 囊 藏 巢 頭 棚 主 工 火 贓 里 憋 點 風 家 鋪 氣 心 子 
鋼=琴 筆 鐵 刀 絲 板 筋 盔 材 骨 彈 軌 管 精 砂 尺 制 錠 架 索 據 梁 纜 包 ? 廠 窗 城 叉 花 化 鋸 口 坯 瓶 槍 圈 釬 繩 條 印 渣 種 針 釘 都 箍 號 炮 片 水 筘 
祝=福 賀 愿 壽 詞 你 禱 酒 您 捷 告 頌 典 
橫=豎 行 溢 暴 幅 掃 貫 肉 財 亙 跨 渡 笛 梁 波 蠻 匾 穿 下 刀 版 排 桿 禍 線 向 逆 過 額 越 濱 生 山 死 流 切 隊 條 飛 的 紋 列 標 陳 道 加 街 空 眉 批 披 豎 事 臥 心 ? 遭 直 地 斷 帆 話 木 躺 寫 著 桁 
遙=遠 望 念 控 感 測 想 祝 指 知 
蒙=古 住 蔽 受 族 混 眼 板 騙 難 語 亮 皮 上 羞 面 特 昧 ? 人 塵 哄 館 垢 事 師 童 文 學 冤 藥 醫 城 蓋 臉 山 陰 
亂=子 來 雜 麻 兵 晃 舞 吹 套 騰 的 世 倫 了 碼 飛 說 花 想 滾 砍 轉 石 用 跑 真 講 發 走 性 叫 動 放 闖 離 臣 黨 乎 紀 民 彈 神 營 泥 扔 蹦 沖 穿 刺 打 丟 堆 搞 畫 擠 箭 交 軍 罵 鬧 弄 切 射 設 視 絲 涂 推 寫 語 
登=載 時 臺 記 高 報 場 陸 門 岸 臨 基 程 機 攀 入 錄 上 山 車 樓 天 月 頂 第 科 出 封 
攤=子 派 販 平 牌 點 位 檔 薄 銷 開 賣 棚 售 手 商 主 上 
黯=淡 然 黑 
唾=沫 罵 棄 液 余 吐 
欽=佩 差 州 定 遲 賜 敬 慕 命 羨 仰 
猶=如 豫 大 太 自 有 在 存 新 然 他 
弄=堂 清 掉 個 權 得 到 傷 污 濕 錯 出 了 好 平 彎 皺 壞 臟 潮 臣 鬼 假 僵 舌 死 通 瓦 璋 暗 粗 倒 丟 懂 短 斷 法 翻 過 混 來 亂 破 缺 水 碎 斜 醒 玉 糟 直 
員=外 工 司 額 會 
籠=罩 子 統 絡 著 屜 頭 火 蓋 民 養 嘴 
腐=敗 爛 朽 化 蝕 臭 尸 竹 惡 熟 殖 壞 儒 乳 舊 生 肉 葉 
懲=罰 治 辦 戒 處 前 
碟=子 機 片 形 
腔=調 骨 子 壁 道 
鳥=兒 獸 雀 類 瞰 巢 槍 啼 林 叫 人 害 聲 飛 人 鳴 籠 糞 市 窩 語 葬 冠 食 翼 爪 嘴 囀 
漆=黑 皮 器 匠 布 料 樹 工 片 雕 封 畫 膜 刷 
瞥=見 視 
惶=恐 惑 然 然 急 遽 悚 
波=蘭 浪 濤 斯 動 瀾 紋 折 及 音 長 谷 幅 恩 段 羅 特 爾 霸 導 蕩 峰 黑 光 譜 束 形 源 磔 昂 包 腹 河 節 密 面 普 前 數 陽 狀 
嶄=新 露 然 
爐=子 火 臺 灶 灰 膛 具 襯 頂 料 溫 邊 齡 橋 條 瓦 型 渣 床 架 門 
敏=感 捷 銳 慧 達 
輿=論 情 
畜=生 牧 力 養 欄 牲 類 產 肥 禽 疫 
糟=蹋 糕 粕 糠 的 了 透 害 改 踐 心 
惡=意 心 霸 劣 人 魔 毒 習 性 果 感 鬼 化 少 戰 報 臭 棍 語 炒 言 疾 的 行 斗 事 女 運 罵 兆 補 名 徒 念 搞 浪 露 變 寒 狗 跡 氣 俗 煞 聲 水 仗 濁 狼 龍 婦 根 漢 極 婆 犬 神 政 癖 
帳=子 篷 幕 內 中 
虐=待 政 戀 打 殺 愛 
牡=丹 蠣 牛 鹿 
板=凳 子 壁 眼 斧 床 滯 鴨 栗 刷 正 車 塊 材 房 面 橋 式 寸 臉 樓 報 擦 蕩 胡 鼓 結 卡 門 球 書 實 條 瓦 型 硬 牙 煙 油 障 層 機 起 巖 載 
禱=告 文 念 祝 
黎=明 民 叔 族 姿 錦 城 曼 平 
災=難 禍 害 荒 區 民 患 情 殃 星 年 后 厄 變 異 
嗡=叫 聲 子 地 
宜=于 人 賓 蘭 昌 興 城 川 春 黃 君 良 山 陽 
鴛=鴦 
掉=轉 頭 淚 落 隊 渣 光 色 了 下 進 到 入 膘 秤 過 價 線 電 
哼=哧 著 唱 唧 唷 聲 
竹=林 子 竿 布 簾 筒 籃 椅 馬 凳 筍 箱 帛 紙 桿 筏 器 席 材 樓 園 簍 籬 籠 板 編 笛 雕 黃 管 節 筐 刻 筷 篾 排 簽 橋 蓀 葉 芋 片 茹 山 溪 笠 
顛=倒 簸 覆 連 末 沛 仆 茄 兒 
魔=鬼 力 術 爪 王 手 法 道 域 人 窟 掌 杖 怪 頭 女 幻 界 障 咒 笛 方 棍 球 獸 芋 影 怔 針 教 鏡 神 
費=事 用 話 勁 時 錢 解 工 難 城 了 電 率 盡 力 心 神 爾 掉 翔 料 縣 
餃=子 
益=處 發 友 蟲 智 鳥 壽 陽 菌 州 
蔣=家 愷 
狠=心 毒 命 抓 辣 地 勁 剎 揍 
鞭=子 炮 策 撻 尸 打 笞 毛 痕 
士=兵 人 氣 女 紳 卒 多 林 官 族 民 
惦=記 念 掛 
潮=流 濕 水 氣 頭 劇 熱 汐 汛 州 解 潤 紅 位 信 繡 涌 音 災 安 差 起 汕 
透=明 徹 露 過 視 風 綠 白 支 辟 光 漏 氣 出 析 鏡 著 平 信 射 入 亮 頂 底 雕 汗 話 骨 墑 水 濕 雨 進 熱 
敢=情 于 為 恨 打 達 言 說 在 問 干 愛 做 講 保 不 當 是 想 冒 死 
圍=繞 裙  巾 困 攻 棋 剿 城 觀 攏 子 屏 脖 獵 爐 護 桌 著 欄 在 住 堵 殲 捕 成 巖 追 嘴 墾 坐 地 場 產 裹 聚 擊 網 兜 起 擒 堰 柵 
營=養 業 救 生 房 造 壘 私 地 建 帳 盤 運 商 辦 收 銷 火 區 口 里 長 部 巢 工 旗 員 寨 山 
號=召 碼 稱 外 令 數 角 頭 子 兵 手 脈 為 牌 衣 房 叫 哭 喪 啕 筒 型 笛 炮 聲 
羞=愧 恥 怯 澀 慚 辱 矜 于 人 赧 惱 憤 口 臊 紅 
葫=蘆 
延=長 安 續 伸 誤 遲 期 平 緩 性 至 展 后 時 慶 請 壽 燒 拓 攬 年 宕 聘 綿 納 邊 髓 用 擱 吉 滯 
森=林 嚴 然 警 郁 
扮=演 相 靚 成 作 酷 蔻 飾 戲 裝 著 
騙=子 人 局 取 色 過 帖 術 了 財 錢 你 得 走 到 貸 匯 購 馬 賣 倒 入 稅 
宮=殿 廷 女 燈 刑 娥 外 調 中 內 門 室 闕 人 城 禁 頸  縮 闈 掖 苑 里 錦 保 
釋=放 文 夢 義 疑 出 迦 懷 然 惑 典 讀 教 卷 手 子 
糖=果 食 人 漿 精 衣 瓜 紙 稀 塊 蜜 水 尿 分 化 類 醋 廠 度 彈 ? 房 膏 色 霜 業 原 罐 酒 稅 漬 
聚=集 會 餐 攏 首 居 合 糖 成 焦 積 落 在 眾 散 賭 酯 星 頭 斂 變 財 伙 匯 光 殲 齊 生 議 結 醚 
借=口 用 故 款 以 鑒 債 助 貸 道 車 個 地 據 讀 支 調 方 條 出 閱 鏡 錢 此 書 了 給 機 來 殼 入 勢 到 重 喻 問 得 腦 代 端 火 光 景 取 宿 位 賬 住 坐 
懶=腰 惰 散 漢 貓 蟲 得 人 怠 婦 到 猴 于 鬼 覺 
巖=石 洞 鹽 漿 溶 壁 層 畫 漿 脈 灘 羊 床 礁 相 屑 心 穴 
廟=宇 會 堂 號 主 祝 子 里 寺 
瞎=子 眼 想 謅 話 抓 闖 了 鬧 掰 編 猜 吹 扯 火 說 信 轉 吵 的 掉 搞 聊 忙 蒙 奶 炮 
摧=殘 毀 折 
啟=發 事 示 蒙 程 齒 迪 封 明 動 用 航 運 德 閉 碇 口 悟 釁 奏 東 功 衡 開 稟 
滄=海 桑 州 浪 江 
素=來 樸 質 凈 菜 材 描 養 日 心 淡 有 食 常 問 女 交 性 雅 志 緞 酒 餐 服 愿 的 以 數 白 稱 敵 裹 潔 色 油 裝 席 
慌=忙 張 亂 促 神 恐 
浴=室 衣 場 缸 盆 池 巾 袍 具 血 帽 液 
植=物 樹 入 根 保 被 苗 皮 株 
骯=臟 
杰=作 出 克 
揭=開 露 發 穿 破 示 去 曉 幕 底 批 陽 秘 榜 標 裱 丑 短 諦 竿 密 牌 蓋 
擾=亂 動 鬧 得 攘 民 人 
襯=衫 托 衣 裙 里 墊 字 映 套 料 領 布 褲 紙 邊 底 砌 
嘗=試 新 到 過 鮮 了 味 一 
晴=天 朗 空 和 雨 綸 好 川 
久=已 仰 違 別 經 留 咳 安 沒 遠 之 病 矣 長 等 旱 慕 聞 居 盼 暫 治 坐 
雨=點 衣 水 天 傘 露 鞋 季 布 腳 滴 里 量 帽 意 景 具 情 中 后 淋 勢 果 林 夜 聲 打 簾 澇 幕 披 前 區 絲 刷 ? 霧 蛙 雪 靴 燕 云 珠 過 田 薇 
憧=憬 
挽=救 回 留 聯 歌 詩 詞 手 帶 弓 具 力 幛 
線=條 索 香 路 頭 下 毯 形 衣 上 圖 性 報 人 圈 型 材 外 充 程 春 蟲 段 規 腳 描 繩 膛 團 襪 裝 軸 管 寬 框 麻 民 狀 
挑=選 戰 剔 撥 起 子 花 釁 夫 逗 唆 揀 動 臺 燈 出 刺 錯 弄 擔 腳 明 食 水 頭 眼 嘴 情 運 中 
版=畫 本 稅 權 圖 塊 面 式 心 次 主 頭 務 規 籍 刻 口 型 納 
冰=冷 涼 箱 雪 塊 糖 窖 凍 河 山 雹 棍 霜 鞋 棒 袋 寒 暴 場 燈 凌 川 柜 島 點 花 球 封 的 毒 刀 期 霧 水 心 釋 上 晶 溜 輪 人 茶 床 ? 船 車 雕 笛 壺 峰 湖 海 糕 鎬 掛 架 片 品 排 瓶 橇 炭 坨 雨 鎮 柱 磚 錐 層 城 蓋 窟 庫 棱 面 室 巖 浴 原 
趁=著 早 勢 機 便 亂 此 熱 空 錢 墑 手 興 愿 
粗=暴 糙 俗 心 野 壯 魯 大 淺 細 疏 鄙 布 笨 劣 話 活 豪 重 獷 陋 糧 率 實 口 言 略 沙 的 體 黑 放 人 拉 糲 菜 讀 短 度 浮 厚 估 工 鋼 狂 看 糠 坑 莽 毛 米 胖 樸 紗 澀 通 線 選 硬 啞 鹽 拙 調 氣 聲 繩 石 制 
臂=膊 膀 腕 力 章 上 彎 助 肘 
仇=恨 人 敵 視 殺 怨 家 讎 外 隙 曉 冤 
懊=悔 惱 喪 恨 
郭=象 熙 靖 芙 襄 
端=詳 正 午 莊 著 接 平 點 倪 的 子 口 坐 陽 上 麗 量 方 節 木 線 緒 由 硯 雅 直 菜 茶 出 過 來 頭 相 
籌=備 劃 碼 款 措 辦 建 集 算 組 募 資 謀 借 拍 商 
尼=姑 龍 亞 斯 采 克 康 
伴=侶 兒 奏 娘 隨 郎 同 月 你 舞 游 我 著 有 唱 讀 星 當 發 送 聲 生 宿 音 
摸=索 清 黑 透 底 得 到 著 出 排 哨 頭 營 觸 過 弄 瞎 
途=中 徑 程 經 次 
障=礙 蔽 子 壁 眼 
暖=和 氣 流 陽 手 房 瓶 壺 的 水 爐 意 風 和 簾 熱 冬 鋒 閣 鍋 色 壽 袖 棚 
胃=口 病 液 癌 腸 炎 酸 部 痛 襞 鏡 腺 石 疼 藥 臟 脘 
玲=瓏 
暴=露 力 躁 動 雨 君 行 徒 風 發 政 虐 烈 病 怒 戾 雪 起 乳 走 跌 利 亂 漲 吏 斂 斃 民 曬 熱 雷 打 富 庫 死 尸 跳 突 瀉 飲 增 卒 尸 舉 牙 
慈=善 悲 愛 祥 母 和 心 姑 父 禧 藹 顏 利 
夕=陽 照 煙 暉 
痰=盂 喘 厥 跡 氣 桶 
稻=草 田 子 穗 米 秧 種 谷 殼 茬 苗 香 
輝=煌 映 光 耀 南 瑞 石 銀 
侄=女 兒 子 孫 婦 媳 
銅=板 錢 元 器 像 鑼 版 鼓 壺 錘 活 匠 臭 幣 綠 模  牌 礦 棒 管 陵 ? 箔 川 廠 錠 佛 鏡 絲 線 焊 片 仁 山 鎖 質 鐘 鈿 
讓=步 給 出 開 路 座 位 道 車 著 賢 我 你 他 人 她 它 這 與 價 不 利 茶 渡 先 作 
脂=粉 肪 膏 油 
傀=儡 
騎=馬 手 士 車 兵  射 師 著 乘 在 術 上 警 標 樓 縫 過 
丟=人 臉 失 掉 棄 丑 勒 球 了 下 份 卻 分 官 架 手 置 開 
訴=說 苦 訟 諸 冤 稱 狀 求 請 權 述 
嗚=咽 呼 
惆=悵 
余=地 音 下 孽 力 波 興 年 毒 威 韻 款 熱 燼 光 黨 糧 數 額 暇 生 悸 震 錢 暉 量 存 
季=節 刊 前 度 軍 報 后 風 斌 候 紅 末 秋 夏 父 
拼=命 湊 音 死 盤 寫 搏 圖 貼 字 出 讀 合 接 力 版 刺 斗 配 搶 殺 爭 綴 裝 了 成 錯 法 勁 攏 
概=念 括 論 略 觀 況 要 貌 述 覽 率 說 數 算 
瀟=灑 湘 
劃=船 子 一 分 算 清 歸 詞 撥 定 界 為 出 艇 上 成 過 破 策 行 線 入 去 到 拉 付 價 槳 款 拳 圈 水 賬 掉 動 法 痕 具 開 傷 手 著 
鳳=凰 冠 舞 棲 蝶 儀 梨 爪 姐 鱭 眼 尾 縣 陽 輦 
襲=擊 用 上 胸 警 擾 來 取 占 人 
寄=托 居 生 存 信 放 宿 養 予 于 籍 給 出 回 望 往 到 來 發 送 上 語 賣 費 售 遞 懷 名 錢 食 身 寓 自 主 住 
叮=囑 嚀 咚 當 咬 問 
班=子 級 禪 車 次 底 房 機 輪 別 上 會 務 委 組 船 長 輩 費 期 師 線 風 規 里 瑪 頭 
李=白 逵 子 贄 銳 鵬 麗 玟 安 明 家 詠 樹 敖 靜 煜 斯 琳 濱 兵 ? 鬼 傕 靖 泉 威 湘 霞 昱 縝 寧 四 冰 龍 強 順 
篇=幅 章 目 頁 名 中 數 子 末 首 
焦=急 躁 灼 黃 點 土 炭 距 作 雷 炙 慮 耳 油 黑 煤 爛 裂 爐 脆 愁 渴 枯 心 棗 比 干 糖 
俘=虜 獲 
瑣=碎 事 細 聞 物 
縮=小 回 短 寫 影 減 頸 到 成 了 印 水 圖 放 孔 編 聚 微 略 尺 合 緊 手 頭 進 排 樣 著 
狂=風 飆 喜 歡 熱 人 妄 吠 暴 亂 潮 呼 言 嘯 頂 氣 草 野 奔 徒 瀾 跌 傲 想 笑 烈 叫 刀 喊 暈 怒 操 放 吼 高 勁 拼 勝 升 肆 濤 舞 瀉 飲 占 躁 吹 猛 鬧 犬 語 ? 
奈=何 良 
恍=惚 如 然 若 悟 
韻=律 文 語 味 腳 事 致 白 母 調 腹 目 書 頭 尾 
祠=堂 廟 
崗=位 子 前 哨 亭 樓 巒 地 尖 卡 
蕩=漾 婦 滌 除 然 平 悠 子 舟 槳 女 起 
茅=盾 屋 草 房 舍 廁 棚 坑 山 廬 庵 臺 
頓=時 然 首 飯 號 成 悟 覺 感 挫 消 足 河 生 音 
遮=掩 蓋 蔽 攔 羞 陽 擋 罩 面 丑 住 藏 護 光 瞞 沒 蔭 斷 簾 上 眼 陰 
逮=捕 住 到 
趨=勢 向 于 附 緩 前 避 動 奉 高 光 緊 時 同 
梧=桐 州 
瓶=子 塞 頸 裝 內 口 膽 蓋 里 中 
愕=然 
譏=笑 諷 刺 嘲 評 誚 
烏=鴉 黑 龜 云 木 ? 賊 金 江 頭 發 拉 龍 雞 海 亮 鱧 蘭 鶇 梅 青 紗 蘇 涂 有 魚 棗 紫 達 藍 篷 檀 藥 
庭=院 園 前 訓 上 中 審 外 除 長 
孝=子 順 敬 心 衣 服 行 經 道 女 廉 感 義 幔 
辜=負 
儒=家 生 教 將 醫 術 學 者 林 垌 艮 商 士 雅 墨 
血=肉 液 汗 色 管 跡 脈 紅 淚 腥 壓 痕 統 性 氣 型 戰 泊 污 緣 水 口 清 債 漬 本 書 案 虧 源 灑 拼 量 光 漿 球 洗 衣 印 崩 親 象 樣 的 流 糖 癌 脂 路 栓 絲 人 尿 泊 斑 仇 沉 滴 防 粉 海 庫 塊 泡 虛 疑 暈 證 腫 錢 站 站 花 凝 染 刃 素 
彩=色 虹 票 畫 繪 禮 旗 云 綢 霞 排 照 車 帶 市 屏 頭 電 棚 塑 陶 妝 券 頁 蝶 燈 金 練 樓 筆 超 瓷 蛋 旦 雕 花 ? 號 管 卷 轎 擴 迷 民 噴 球 聲 飾 顯 信 印 釉 紙 調 度 橋 圖 
黨=員 派 委 政 務 徒 錮 魁 報 綱 羽 證 組 籍 史 章 紀 齡 團 閥 費 風 禁 課 票 旗 性 的 內 人 部 群 規 校 外 參 徽 法 棍 國 建 刊 項 爭 辦 軍 義 營 
籃=子 球 板 筐 壇 圈 網 協 
丑=惡 角 陋 態 事 聞 化 劇 女 類 的 旦 話 時 史 行 星 相 怪 名 
陷=落 入 于 阱 害 坑 在 沒 身 陣 波 進 住 
喃=
像=片 似 是 個 素 不 話 樣 章 差 
遵=守 照 命 從 循 化 行 奉 義 紀 依 囑 
尸=體 首 身 骨 骸 蠟 斑 檢 位 僵 衣 
鸚=鵡 哥 
待=遇 人 客 命 考 她 業 續 辦 查 機 援 定 我 他 發 在 你 物 會 用 崗 到 批 決 售 產 承 婚 建 見 聘 其 審 時 攤 字 詔 工 嫁 
誣=蔑 陷 告 賴 稱 害 枉 栽 
挺=起 直 拔 身 立 進 像 難 括 胸 好 多 舉 強 尸 脫 秀 大 高 腰 有 
課=堂 程 本 外 題 文 時 目 上 標 業 表 間 稅 桌 余 后 前 件 內 改 卷 長 以 征 
疏=遠 忽 散 通 懶 漏 理 松 離 導 于 落 失 浚 解 朗 放 剪 狂 闊 密 苗 淺 挖 虞 影 運 枝 附 果 
狼=狽 狗 毫 瘡 孩 獾 藉 窩 煙 牙 主 毒 人 嗥 
央=求 告 行 視 托 中 
探=聽 望 索 險 問 病 親 討 詢 視 求 測 訪 子 究 戈 明 到 路 礦 查 井 秘 尋 頭 源 微 監 析 知 出 勝 案 雷 察 花 風 家 勘 空 馬 區 身 傷 試 悉 幽 長 針 春 
徐=州 緩 克 的 
煤=油 球 氣 礦 屑 炭 爐 煙 渣 灰 廠 車 田 井 火 窯 層 末 耗 場 塵 塊 業 餅 化 質 磚 倉 黑 焦 精 坑 庫 桶 系 
桂=林 花 枝 圓 冠 城 竹 皮 劇 陽 子 東 平 
窟=窿 穴 宅 
迫=切 害 使 近 于 令 臨 降 
雄=偉 壯 心 厚 雞 性 風 關 姿 圖 鷹 兵 師 蕊 威 文 的 獅 霸 渾 辯 才 踞 麗 大 蜂 花 黃 飛 豪 居 健 勁 杰 峻 奇 起 視 武 主 鹿 貓 鳥 強 縣 蟻 州 
萌=芽 動 生 發 蘗 育 
驅=逐 使 除 車 趕 遣 動 散 蚊 走 邪 策 寒 迫 蟲 出 
潔=白 凈 麟 具 本 癖 身 
陣=地 亡 線 營 雨 勢 痛 容 行 腳 子 風 式 發 列 前 兒 法 形 
約=定 略 束 會 請 稿 法 言 分 數 有 為 占 翰 見 需 克 旦 好 談 同 期 集 計 據 摸 
裁=縫 判 減 斷 紙 量 剪 決 軍 員 定 處 兵 切 編 并 撤 奪 度 退 汰 酌 制 成 刀 衣 
牲=口 畜 靈 禮 
挖=苦 掘 井 出 泥 土 走 補 洞 方 根 空 潛 溝 開 坑 通 下 
矜=持 憐 夸 
慰=勞 問 藉 唁 安 撫 勉 
咒=罵 語 符 詛 文 
絨=線 衣 毯 花 布 球 毛 帽 褲 繡 氈 
穩=定 當 重 健 固 妥 住 步 如 操 便 練 產 壓 坐 拿 獲 婆 實 態 
額=角 外 頭 數 上 度 定 骨 發 敏 前 飾 
俏=皮 麗 貨 式 頭 銷 
梳=頭 洗 妝 子 理 篦 齒 攏 
定=下 神 睛 義 律 都 價 期 居 見 名 親 局 然 型 位 論 錢 做 理 計 罪 時 稿 準 奪 例 心 案 購 向 性 語 點 額 弦 編 為 會 是 于 出 能 可 要 在 將 人 當 量 存 息 格 好 制 相 力 心 日 本 數 調 金 情 安 形 規 式 影 住 禮 產 鼎 崗 更 級 評 勢 損 說 銷 限 員 音 約 則 址 邊 標 幅 海 結 界 南 票 碳 陶 西 襄 興 遠 州 
虔=誠 敬 心 
撒=謊 手 嬌 野 潑 布 向 加 播 旦 種 拉 網 尿 賴 落 把 村 歡 開 氣 腿 刁 滿 沙 
促=進 成 使 請 銷 產 動 脈 其 退 膝 狹 織 
求=學 婚 得 生 人 助 愛 救 情 知 教 饒 真 告 全 援 實 見 和 偶 歡 疵 醫 證 職 你 神 診 其 我 取 是 變 精 新 解 出 售 才 勝 同 償 你 成 索 利 雨 簽 繞 榮 導 購 借 靠 親 乞 賢 仙 治 戰 根 積 搖 值 
寓=言 公 意 于 義 所 居 邸 目 
榜=樣 單 文 首 上 額 書 尾 眼 
耗=子 費 盡 去 光 完 損 資 用 材 時 電 油 能 竭 神 散 
疾=病 馳 苦 風 奔 步 駛 患 呼 行 走 進 書 速 跑 驅 首 
徒=弟 然 手 刑 勞 步 孫 有 工 涉 長 
乘=機 客 涼 車 勢 船 除 坐 隙 興 法 數 以 著 座 務 上 時 龍 便 方 號 積 警 冪 勝 虛 員 載 筏 間 馬 
喘=氣 息 氣 
泰=山 國 納 斗 銖 興 文 勒 安 坦 拳 和 來 然 森 水 語 寧 順 州 族 
荷=葉 花 包 蘭 澤 甲 馬 塘 鋤 重 載 香 語 
俗=語 稱 話 字 套 名 家 尚 世 事 人 化 講 氣 曲 體 態 物 諺 子 艷 
嘀=咕 嗒 
召=集 開 喚 見 到 回 妓 來 禍 
驟=然 變 增 降 起 雨 雪 
庸=俗 人 碌 醫 才 材 夫 
億=萬 元 噸 兆 
榮=譽 幸 耀 辱 獲 光 華 膺 登 升 立 歸 任 成 典 軍 枯 
累=贅 人 積 倒 活 年 次 計 加 進 了 的 得 死 月 卵 不 犯 及 垮 病 日 世 牘 
案=子 件 頭 情 卷 首 例 犯 由 中 發 底 秤 牘 幾 宗 值 
棍=子 棒 
栗=子 色 然 暴 鼠 
頹=廢 勢 頂 然 喪 敗 放 風 靡 唐 塌 運 壞 
露=面 水 天 骨 珠 臉 宿 頭 酒 怯 點 著 乳 拙 營 臺 了 點 在 臍 背 白 布 出 丑 底 底 地 風 富 苗 相 餡 齒 光 肩 
逼=迫 近 真 供 急 出 走 你 使 人 和 我 得 著 婚 宮 命 平 搶 視 問 肖 債 進 上 死 她 向 
喚=起 醒 頭 作 回 出 
抒=情 寫 發 懷 
夾=雜 襖 道 衣 子 攻 帶 縫 板 被 棍 雪 上 菜 擊 注 層  克 在 心 著 盤 住 角 剪 具 批 生 塞 到 江 緊 鉗 人 入 頭 
瘦=長 削 小 弱 子 肉 瘠 身 了 的 臉 溜 癟 猴 高 果 地 馬 
疙=瘩 疤 
悅=耳 目 服 人 意 
循=環 序 例 吏 
脊=梁 背 椎 髓 柱 檁 索 鰭 
羊=肉 角 毛 皮 羔 倌 腸 奶 毫 齒 群 城 頭 絨 羹 工 膜 圈 水 眼 道 叫 欄 排 舍 桃 腿 脂 
晝=夜 盲 
悠=閑 久 長 揚 然 游 蕩 忽 美 謬 遠 然 哉 著 
遍=地 布 及 數 尋 野 歷 覽 訪 身 體 于 
忌=諱 恨 日 辰 妒 憚 酒 口 刻 語 嘴 食 
拆=開 散 卸 毀 除 洗 穿 臺 遷 線 息 建 掉 解 借 下 成 伙 零 兌 封 分 換 改 賣  信 裝 賬 字 機 舊 橋 用 閱 
衰=老 弱 落 退 亡 了 減 竭 敗 微 變 人 憊 草 邁 替 頹 萎 歇 朽 
魅=力 人 惑 
側=面 耳 門 重 室 對 擊 后 翼 目 身 記 邊 臥 柏 扁 滑 架 近 視 線 影 泳 枝 足 歪 堡 壁 部 方 腹 柱 轉 
撫=摸 養 慰 愛 育 恤 順 平 弄 摩 琴 州 媚 寧 松 遠 
嚷=著 叫 鬧 
嬸=母 娘 子 婆 
步=行 驟 子 伐 兵 履 哨 槍 調 入 出 進 法 長 態 道 測 幅 弓 武 韻 高 犁 速 
紐=約 扣 子 帶 結 襻 
怨=恨 氣 言 婦 誰 我 你 念 憤 聲 偶 女 仇 懟 毒 敵 府 望 艾 悔 尤 
豪=杰 華 爽 放 邁 門 俠 橫 富 氣 情 豬 語 舉 紳 飲 客 強 壯 宅 雨 賭 奪 士 奢 商 族 薩 無 勇 右 
段=子 落 中 位 長 譽 名 
章=程 法 句 節 魚 草 則 子 動 回 丘 
祈=禱 求 望 愿 福 年 盼 
速=度 寫 率 記 達 死 射 遞 成 勝 查 歸 讀 算 凍 溶 編 比 滑 決 生 效 戰 描 食 
蛋=糕 粉 黃 白 羹 清 類 兒 卷 雞 殼 品 青 子 酒 形 
拱=手 門 橋 豬 形 背 讓 抱 璧 頂 火 棚 衛 道 基 廊 路 起 圈 石 狀 
汗=珠 衫 水 毛 顏 青 漬 褂 堿 液 腺 臭 滴 腳 孔 漫 斑 濕 味 血 
婊=子 
褂=子 兒 
甲=板 午 蟲 申 等 魚 方 殼 烷 組 級 類 型 酚 肝 基 乙 子 醛 骨 醇 苯 兵 亢 醚 酸 胄 種 第 士 癬 藻 紫 
肺=病 炎 癆 腑 部 葉 癌 魚 臟 泡 脹 
乖=巧 覺 僻 戾 剌 不 舛 的 兔 蹇 謬 順 違 張 
諒=解 必 察 
壯=麗 丁 烈 士 觀 大 年 實 健 志 美 舉 膽 族 歌 心 錦 闊 陽 漢 苗 懷 工 偉 行 戲 語 碩 
悵=惘 然 恨 惋 
斟=酌 酒 茶 
綽=號 約 
涉=及 獵 足 槍 毒 外 嫌 案 水 農 筆 禽 世 訟 險 法 過 
泉=水 源 眼 州 流 幣 下 涌 石 城 
妄=想 念 言 談 圖 語 稱 動 為 自 加 人 斷 求 取 說 
拖=鞋 延 住 累 欠 沓 曳 船 把 駁 網 走 著 慢 車 拉 輪 垮 到 長 板 放 出 后 動 入 布 帶 沓 斗 宕 糞 掛 腔 堂 運 地 進 具 纜 裙 濕 臟 拽 
掃=除 興 地 蕩 帚 射 墓 視 盲 圖 踢 腿 了 描 瞄 毒 平 把 黃 清 雷 過 盲 黑 祭 滅 數 地 榻 聽 尾 雪 一 倒 墳 來 去 完 
呵=欠 斥 護 叻 喝 責 
貧=窮 困 乏 民 富 苦 血 農 寒 賤 弱 瘠 乳 化 窶 礦 氣 僧 嘴 道 家 鈾 油 
肌=肉 膚 群 瘤 理 體 腱 注 
饒=恕 命 了 有 人 舌 頭 河 平 
斯=文 基 坦 人 諾 
儐=相 
品=質 性 格 行 德 種 味 位 評 嘗 級 貌 勝 類 藍 節 名 目 牌 出 管 茗 系 第 酒 茶 讀 紅 冠 鑒 色 賞 脫 題 相 學 議 月 藻 族 綠 
慎=重 用 防 選 思 言 獨 于 
廠=子 長 家 方 房 主 務 商 址 礦 內 里 牌 名 史 區 慶 齡 容 標 部 規 紀 價 休 醫 長 辦 場 籍 外 
省=城 去 力 份 會 掉 略 府 市 委 廳 界 籍 級 的 卻 時 錢 下 區 內 電 察 思 了 中 油 優 外 立 事 行 吧 親 報 便 得 際 勁 儉 屬 心 垣 長 直 志 治 悟 道 地 里 用 
憑=空 據 吊 借 證 藉 單 著 信 祥 欄 陵 靠 恃 眺 險 依 仗 照 
沸=騰 水 點 熱 泉 煮 石 
瞪=眼 著 視 大 羚 
予=以 人 
尷=尬 
辣=椒 子 手 醬 味 的 妹 根 油 
魂=靈 魄 歸 斷 夢 
洪=水 流 亮 大 鐘 爐 恩 福 量 災 峰 濤 澇 幫 波 洞 荒 害 湖 魔 武 熙 虎 都 江 門 澤 
碧=桃 綠 玉 海 空 波 血 咸 天 瑤 水 藍 落 草 潭 透 眼 云 
豈=但 止 料 能 不 非 可 是 有 會 知 容 敢 肯 
堆=積 砌 放 房 棧 疊 焊 滿 場 存 垛 肥 集 笑 成 起 有 置 
嫵=媚 
室=內 外 女 溫 里 友 
賣=弄 國 身 命 淫 過 你 卡 色 主 勁 方 乖 價 點 出 給 場 了 得 掉 到 家 座 力 空 相 藝 粥 老 唱 春 呆 底 好 功 票 俏 錢 笑 解 友 嘴 報 菜 光 酒 完 文 者 
入=睡 學 門 手 口 耳 獄 殮 席 座 伍 黨 神 場 骨 時 畫 侵 選 夜 聲 土 夏 魔 超 股 境 群 團 贅 伙 會 住 市 世 球 院 網 內 主 戶 到 圍 水 賬 海 眼 教 關 室 閣 懷 定 港 伏 托 塢 道 迷 微 籍 腦 夢 冬 庫 云 園 秋 味 洞 流 列 壟 理 倉 春 隊 檔 行 彀 寂 靜 鏡 九 寇 款 眠 梅 寐 暮 聘 寢 射 闈 緒 邪 藥 駐 編 廁 官 
薔=薇 
卑=鄙 劣 污 賤 怯 微 下 尊 詞 辭 瑣 俗 職 陋 
龐=大 雜 龍 貝 
符=號 合 咒 ? 節 碼 尾 
厚=重 道 實 意 薄 禮 望 度 誼 的 德 待 非 愛 利 顏 板 恩 祿 臉 賜 樸 味 謝 遇 葬 的 片 生 澤 紙 
謊=話 言 報 稱 價 騙 信 
廁=所 身 足 
矯=正 健 捷 形 命 情 飾 治 直 
笛=子 聲 膜 手 
陪=伴 客 同 嫁 襯 房 審 我 著 酒 葬 送 練 奩 聊 綁 床 餐 讀 吊 斗 護 假 祭 考 侍 夜 泳 住 從 都 笑 音 
卡=車 片 通 死 子 其 拉 爾 特 在 式 鉗 門 殼 住 紙 號 恩 尺 帶 夫 規 具 殼 巴 口 諾 盤 他 
犄=角 
妖=精 魔 怪 艷 孽 氣 媚 冶 嬈 術 言 物 霧 道 風 姬 法 婦 鬼 猴 女 人 
盛=開 行 大 世 會 宴 況 名 意 情 年 事 典 夏 裝 贊 舉 譽 產 服 傳 放 衰 怒 唐 器 飯 季 ? 景 期 暑 銷 筵 饌 菜 觀 滿 時 
歇=息 業 腳 著 下 腳 涼 氣 菜 鞍 班 頂 乏 伏 會 工 假 肩 晌 手 宿 腿 陰 夜 枝 
眨=眼 眼 巴 
嘮=叨 扯 嗑 
屏=風 息 障 條 幕 氣 除 蔽 東 退 保 門 聲 南 山 
懸=掛 崖 空 殊 念 案 梁 賞 鐘 架 棺 浮 梯 疑 吊 擬 臂 垂 揣 乎 壺 河 隔 停 腕 望 心 巖 壁 瀑 置 著 
妒=忌 嫉 火 恨 意 
愈=加 來 益 發 合 好 見 近 甚 
咀=嚼 
伶=俐 人 仃 俜 
蹂=躪 
隆=重 起 興 響 盛 冬 胸 乳 情 慶 準 安 昌 德 化 回 聲 肉 暑 堯 中 
傲=慢 然 氣 視 骨 游 岸 人 世 霜 物 
毅=然 力 勇 夫 
津=貼 液 潤 梁 渡 要 城 門 
呈=現 文 請 報 獻 子 有 遞 交 上 閱 祥 覽 露 送 政 正 示 
施=行 展 舍 工 主 用 放 加 肥 政 以 壓 教 恩 予 暴 樂 與 洗 救 惠 法 虐 藥 禮 粉 威 訓 齋 診 秉 甸 力 治 
抑=制 郁 或 菌 止 揚 
治=病 療 國 安 理 學 水 罪 本 標 所 市 喪 權 愈 好 山 平 亂 廠 保 蟲 蝗 軍 家 堿 沙 污 校 印 裝 多 教 世 稅 
稀=飯 奇 少 罕 疏 薄 有 松 爛 客 泥 釋 世 土 拉 朗 料 落 貴 缺 粥 糟 植 的 性 
敞=開 亮 車 篷 領 露 口 快 
妞=兒 子 
掀=起 動 開 翻 
刀=槍 子 叉 筆 柄 刃 兵 傷 鋒 法 把 口 身 光 斧 上 魂 背 兒 片 劍 下 匠 割 具 疤 痕 尖 架 鞘 山 術 魚 俎 郎 頭 豆 工 客 削 
鄙=人 夷 視 薄 棄 陋 吝 俗 意 見 俚 稱 夫 
嫁=人 妝 掉 給 娶 禍 入 到 奩 接 
禽=獸 畜 鳥 蛋 舍 類 
靦=腆 
罐=頭 子 裝 籠 車 
貪=污 婪 圖 多 官 財 心 玩 求 戀 欲 小 睡 吃 食 杯 賄 墨 青 權 色 生 贓 嘴 占 歡 
瞻=仰 望 禮 念 顧 
勤=勞 苦 儉 快 奮 懇 務 勉 力 學 于 練 謹 王 雜 政 樸 
睫=毛 
哀=求 樂 愁 悼 號 叫 嘆 鳴 傷 痛 思 告 歌 哉 怨 慟 哭 懇 憐 婉 辭 吊 鴻 矜 泣 切 訴 啼 祭 家 感 嚎 呼 喚 憫 
賞=識 鑒 錢 光 賜 金 景 了 罰 析 月 花 給 臉 封 格 菊 玩 閱 面 
攜=手 帶 款 風 眷 
陜=西 北 南 
彎=腰 曲 子 路 度 矩 管 角 道 兒 刀 弓 頭 繞 月 的 回 腳 起 身 腿 下 
曠=野 課 了 工 古 世 達 代 蕩 廢 費 遠 職 
廊=子 下 道 坊 檐 
柿=子 餅 霜 
盲=目 人 腸 從 動 流 棋 區 點 打 道 干 谷 童 文 信 校 杖 字 
郵=票 局 差 船 寄 政 電 遞 件 筒 費 包 戳 購 花 資 亭 箱 址 報 輪 編 路 品 務 發 碼 展 盤 車 袋 匯 集 迷 市 商 售 區 
瑞=士 典 雪 香 金 安 星 麗 簽 云 能 昌 利 氣 
針=線 對 尖 眼 腳 形 式 鋒 孔 織 劑 灸 頭 筒 刺 鼻 砭 插 法 箍 管 葉 藥 黹 麻 芒 扎 狀 
吉=祥 利 日 兇 林 普 兆 他 慶 姆 爾 星 安 劇 時 言 伯 達 隆 首 水 斯 它 縣 
遷=移 就 居 怒 都 徙 往 入 出 離 到 至 建 延 走 葬 安 進 去 
搶=劫 先 救 奪 掠 注 鮮 位 過 樓 修 手 購 險 運 眼 走 去 攻 灘 占 著 種 鏡 到 建 答 在 白 點 斷 渡 話 光 截 跑 拍 親 球 收 市 嘴 法 來 
倔=強 
鈴=聲 鐺 木 舌 鐸 蟲 鼓 蘭 響 
護=士 送 兵 照 衛 短 理 住 腕 耳 膚 法 航 養 持 路 花 國 駕 身 封 罩 佑 林 欄 領 綠 壁 從 工 耕 具 肩 假 苗 坡 青 權 守 腿 膝 胸 院 板 喉 教 面  套 肘 
揮=手 霍 動 舞 灑 毫 淚 拳 發 刀 臂 別 筆 鞭 斥 汗 戈 師 劍 寫 
墨=水 盒 汁 筆 跡 家 鏡 寶 竹 魚 綠 色 客 吏 斗 點 海 黑 晶 菊 守 香 線 刑 鴉 漬 經 囊 脫 玉 
池=塘 子 水  沼 中 邊 州 內 上 堂 湯 鹽 浴 座 莉 魚 
斜=陽 坡 眼 視 面 扛 角 井 路 切 線 紋 的 體 度 槽 杠 睨 楞 率 邊 道 暉 射 照 桿 高 過 頸 橋 塔 壓 倚 軸 著 
挫=折 敗 傷 損 
梯=子 田 級 隊 形 次 狀 恩 度 河 思 
弦=子 線 歌 樂 聲 月 
防=備 空 線 范 止 御 衛 守 疫 火 控 黑 反 護 區 毒 風 旱 腐 洪 水 務 盜 澇 治 曬 暴 滑 偽 癌 震 撞 患 漏 病 的 潮 污 塵 蟲 爆 縮 身 災 彈 老 霉 具 凌 熱 除 磁 凍 地 寒 化 齲 暑 汛  蛀 避 城 臭 軍 雷 冷 ? 人 砂 沙 碎 雨 
昏=暗 迷 亂 倒 睡 沉 厥 聵 眩 君 濁 黃 黑 話 花 憒 死 星 庸 暈 著 頭 
仰=望 臥 慕 仗 臉 角 賴 天 頭 承 光 給 殼 面 視 首 身 泳 起 
涌=現 浪 入 出 進 上 起 泉 來 流 潮 動 向 
肥=皂 胖 大 肉 美 沃 豬 料 碩 壯 缺 水 臀 羅 田 瘦 腸 實 仔 的 效 分 育 牛 力 差 厚 活 私 腴 矮 滿 嫩 土 西 
陶=醉 器 冶 瓷 土 藝 塑 然 吧 紅 虹 管 工 鈞 文 瓦 俑 鑄 ? 都 罐 樂 潛 制 磚 
辨=別 認 識 偽 證 析 明 出 正 才 清 士 
跌=倒 落 傷 停 跤 價 幅 破 勢 到 下 入 進 死 宕 風 份 水 足 坐 
泛=濫 指 稱 綠 出 起 舟 紅 論 讀 化 酸 音 白 黃 美 談 
芝=麻 蘭 諾 
彌=漫 補 勒 留 撒 散 陀 合 封 縫 堅 蒙 天 望 月 
豎=起 立 琴 排 子 線 幅 行 井 直 笛 著 
懦=弱 夫 
暮=色 年 氣 靄 春 冬 景 秋 歲 
滔=天 地 
輾=轉 過 
虧=得 空 本 待 損 心 欠 耗 蝕 折 秤 產 短 負 了 缺 
股=東 票 份 本 道 市 息 骨 利 權 價 數 民 指 海 災 金 評 匪 肱 迷 事 友 長 子 值 
餅=干 子 鐺 肥 屋 
跨=過 上 界 入 越 度 境 國 進 區 出 海 跳 騎 著 省 欄 步 行 徑 業 接 距 洋 坐 
策=略 劃 動 士 反 應 勵 馬 論 勉 發 勒 
廈=門 華 
輸=入 贏 送 出 血 液 氧 了 給 的 掉 電 得 家 水 錢 棋 誠 定 導 光 將 理 去 油 者 紙 
唐=詩 山 花 代 宋 朝 人 裝 僧 寧 雎 求 突 琬 寅 海 河 上 縣 
序=言 文 跋 幕 目 曲 列 論 數 號 齒 性 章 
癢=處 疹 
堵=住 塞 截 口 車 擊 心 嘴 漏 死 
鐲=子 
臭=蟲 味 氣 罵 椿 氧 的 棋 屁 顯 腳 美 名 錢 腺 水 鼬 
敲=打 詐 門 響 定 擊 門 鐘 入 鍵 出 掉 過 進 開 空 鑼 破 碎 下 
鉆=石 研 營 戒 頭 心 洞 過 尖 空 子 到 了 探 孔 進 出 入 床 桿 工 勁 井 機 謀 塔 臺 
致=謝 敬 力 意 死 使 富 以 函 電 哀 禮 密 辭 癌 命 歉 送 病 信 賀 醉 遠 冷 殘 傷 用 
叛=變 徒 逆 亂 軍 賣 兵 匪 國 離 黨 逃 
軀=殼 體 干 
茉=莉 
悼=念 詞 祭 亡 唁 
嚇=人 唬 倒 阻 成 得 壞 到 死 跑 呆 退 她 他 昏 住 
齊=聲 整 全 心 備 集 鳴 國 步 名 腰 天 放 丹 唱 家 聚 魯 人 了 發 秦 楚 浣 飛 市 頭 豫 奏 車 耳 河 肩 力 眉 射 手 
派=頭 別 出 遣 員 系 兵 隊 生 發 對 息 人 往 駐 到 送 給 來 去 上 克 差 活 赴 購 款 性 選 司 
頸=項 椎 部 巾 聯 子 背 圈 
矮=小 子 胖  桿 個 人 的 凳 星 得 短 墩 化 腳 樹 了 林 
燕=子 窩 山 兒 麥 巢 雀 京 青 國 尾 魚 趙 
宋=朝 元 史 詩 代 詞 人 華 江 柯 體 健 平 強 
航=船 空 行 海 程 線 段 路 模 向 班 速 運 天 道 母 寄 展 次 齡 標 測 拍 圖 務 校 宇 材 渡 跡 
芬=芳 蘭 香 
佃=戶 農 租 東 客 
羽=毛 翼 紗 緞 扇 絨 化 冠 泉 壇 片 飾 衣 軸 
仙=人 鶴 女 境 姑 子 桃 丹 逝 草 樂 山 劍 界 居 翁 鄉 家 氣 術 臺 游 
鑒=賞 定 別 于 戒 證 諒 認 識 真 
史=詩 料 學 實 書 官 冊 前 跡 載 傳 稱 籍 話 評 上 記 論 家 地 略 觀 部 抄 館 劇 學 青 事 
灑=脫 掃 落 淚 在 水 下 家 遍 滿 
奢=侈 望 華 求 念 靡 談 想 
腰=帶 包 板 肢 部 身 子 眼 圍 桿 椎 刀 系 疼 里 際 腳 鼓 花 間 斬 背 痛 骨 果 酸 袋 鍋 腿 布 纏 的 門  彎 
頂=多 點 住 撞 子 棚 端 針 峰 替 牛 下 個 風 板 蓋 級 尖 部 層 包 上 樓 著 頭 芽 帖 禮 班 燈 戴 好 崗 缸 杠 格 角 命 盤 球 數 天 箱 心 用 葉 一 賬 嘴 罪 職 真 珠 吹 篷 起 塔 
獎=勵 金 券 賞 章 品 牌 狀 杯 項 懲 售 罰 額 次 酬 級 旗 臺 掖 挹 
橋=梁 頭 洞 欄 畔 邊 接 牌 身 面 墩 孔 段 下 涵 基 堍 樁 板 東 拱 臺 
琵=琶 音 
烈=士 火 日 女 馬 焰 性 酒 屬 風 度 婦 暑 
床=頭 鋪 單 板 架 位 榻 墊 子 罩 上 邊 褥 前 下 幃 沿 笫 底 蓋 柱 
狹=小 窄 長 隘 義 帶 縫 谷 口 路 巷 
押=韻 款 解 送 車 運 注 回 后 匯 對 寶 當 隊 金 禁 頭 題 尾 賬 租 給 往 
援=助 救 引 軍 例 藏 交 兵 手 用 筆 建 款 外 藏 敵 
審=查 美 判 問 視 定 察 慎 訊 閱 理 核 度 稿 議 批 計 結 案 訂 干 題 辦 處 讀 改 校 看 評 聽 驗 
列=車 寧 傳 舉 入 國 為 強 席 隊 出 島 好 兵 表 于 在 支 子 當 位 項 夫 維 陣 
剪=刀 裁 子 影 貼 紙 彩 輯 枝 報 接 除 下 發 去 短 掉 斷 開 成 徑 滅 毛 票 切 過 力 取 
浮=動 現 淺 云 腫 沉 泛 雕 橋 面 萍 躁 華 蕩 游 土 上 財 塵 名 艷 屠 標 灰 力 石 子 升 選 生 起 出 水 夸 冰 報 槎 詞 厝 吊 點 滑 記 克 皮 漂 筒 頭 箱 想 員 油 沈 山 渣 舟 
僻=靜 壤 陋 典 巷 遠 
器=具 皿 物 官 械 重 材 量 樂 件 用 宇 
昔=日 時 年 陽 人 
踐=踏 約 諾 行 祚 
帖=子 數 服 
慘=案 白 劇 痛 狀 死 敗 殺 重 變 禍 象 毒 遭 境 烈 淡 了 怛 叫 況 厲 然 景 苦 笑 跌 事 
櫥=窗 柜 
替=代 換 身 班 補 你 工 角 手 
持=久 續 重 家 有 平 籌 股 槍 守 刀 卡 正 球 論 倉 衡 法 身 械 齋 盈 
蔚=藍 然 
寥=落 寂 廓 
患=難 者 病 處 上 有 
碎=片 磚 塊 銀 米 末 石 裂 屑 步 花 布 粉 煤 肉 紙 
媒=人 介 婆 質 體 妁 怨 子 
蟋=蟀 
疼=痛 愛 惜 我 人 憐 
僥=幸 
飄=揚 蕩 然 浮 然 落 動 零 灑 搖 散 帶 走 向 柔 去 滿 進 舞 忽 逸 香 游 來 雪 過 到 擺 塵 飛 拂 紅 海 逝 云 運 溢 曳 移 悠 展 起 雨 
膏=藥 粱 血 油 筆 車 肓 火 劑 墨 腴 澤 子 
粽=子 
守=備 舊 衛 節 護 候 法 靈 望 軍 歲  勢 則 車 財 敵 在 住 著 信 時 門 正 將 夜 約 紀 業 家 好 擂 兵 成 服 寡 宮 墓 喪 身 土 孝 職 制 邊 城 
勾=結 當 引 搭 通 畫 銷 住 股 上 玉 起 勒 出 選 留 欄 連 臉 除 兌 魂 繪 踐 描 芡 手 乙 掉 掛 號 球 去 人 消 
聞=名 人 訊 之 到 聲 者 風 道 得 出 知 了 達 聽 悉 見 喜 
奉=命 承 獻 陪 行 送 還 養 告 勸 上 為 旨 令 達 調 復 化 公 敬 使 祀 托 迎 贈 天 賢 新 
賠=錢 款 償 笑 本 禮 罪 了 率 補 錯 墊 還 付 話 命 情 賬 
溪=水 流 畔 口 河 邊 澗 壑 谷 卡 刻 岸 北 湖 
付=印 出 與 款 清 訖 諸 費 錢 給 賬 現 丙 排 托 型 息 郵 梓 掉 還 足 
振=作 興 奮 動 蕩 翅 聲 臂 拔 幅 發 刷 搗 鈴 起 
層=次 面 數 高 樓 位 級 疊 出 壓 析 林 巒 流 報 云 理 排 狀 
癡=心 情 子 呆 迷 人 愛 戀 肥 話 狂 夢 傻 笑 想 長 醉 
滾=蛋 熱 燙 動 圓 邊 水 入 到 過 木 翻 輪 珠 軸 球 筒 柱 存 下 落 雷 打 刀 沸 肥 開 梯 湯 壓 杯 出 進 屏 涕 裝 子 
督=軍 促 辦 撫 察 查 導 學 率 工 戰 陣 造 脈 師 
淹=沒 了 死 留 博 灌 埋 水 
悶=氣 熱 雷 笑 棍 死 罐 酒 倦 頭 火 燒 聲 住 著 
謀=生 殺 害 反 略 求 士 劃 財 取 臣 利 面 私 慮 和 算 事 陷 職 得 叛 
助=手 教 長 威 理 興 詞 產 耕 人 他 我 學 陣 益 推 選 力 攻 燃 殘 工 劑 跑 研 戰 困 散 
磚=頭 瓦  塊 窯 石 茶 雕 坯 廠 匠 片 
汪=洋 叫 
眺=望 
蜘=蛛 
騾=子 馬 夫 
柵=欄 極 格 門 
狐=貍 仙 步 臭 媚 疑 皮 裘 臊 猴 
元=氣 寶 曲 旦 宵 帥 首 素 老 月 兇 勛 末 件 音 代 年 錢 朝 祖 明 日 戎 惡 麥 秋 夜 稹 級 功 謀 培 山 史 氏 陽 子 組 
枝=葉 頭 條 節 子 干 杈 柯 蔓 丫 城 江 
洶=涌 
毯=子 
匯=報 集 編 票 合 款 流 兌 演 豐 率 價 市 入 出 攏 展 費 總 成 融 付 寄 民 算 水 映 到 進 
刻=薄 苦 本 畫 板 毒 意 出 盤 有 上 下 工 版 度 印 成 錄 刀 骨 寫 字 痕 鐘 
騷=動 擾 亂 人 客 比 貨 體 
煽=動 惑 情 起 
綜=合 觀 治 評 藝 述 覽 
售=出 價 賣 貨 票 樓 罄 后 完 書 房 前 
荊=棘 條 芥 州 軻 門 沙 
瓷=器 瓶 磚 雕 實 缸 土 窯 廠 都 料 盤 釉 
裸=體 露 照 女 奔 機 麥 聊 視 線 眼 裝 的 睡 袒 
撇=下 開 棄 脫 嘴 掉 去 
譴=責 謫 
捧=場 起 好 紅 杯 走 讀 腹 哏 角 殺 星 得 
喧=嘩 鬧 囂 嚷 響 擾 沸 叫 騰 闐 天 笑 雜 噪 器 騷 用 
壁=畫 爐 報 虎 壘 櫥 燈 紙 掛 上 毯 立 布 柜 龕 球 飾 虱 鐘 障 柱 
暢=快 談 銷 通 游 達 飲 行 順 旺 當 懷 抒 想 敘 流 茂 
核=桃 算 心 兒 準 對 計 戰 實 子 減 仁 電 定 武 查 銷 發 能 彈 酸 力 果 批 審 收 素 糖 驗 資 價 菌 膜 網 液 質 ? 
蜻=蜓 
撤=退 換 銷 職 回 消 出 除 離 下 去 了 走 兵 并 防 完 案 標 編 差 崗 軍 免 訴 市 展 資 到 掉 席 營 
獰=笑 惡 
衷=心 腸 情 曲 
哽=咽 塞 噎 
藥=房 方 水 品 物 店 鋪 材 片 箱 味 酒 費 料 草 膏 丸 性 療 庫 盒 餌 劑 棉 用 單 力 粉 面 液 皂 業 的 師 廠 學 檢 效 理 商 膳 局 農 量 補 叉 茶 典 衡 罐 谷 具 瓶 書 筒 王 械 引 浴 疹 渣 枕 包 害 價 名 囊 
鞏=固 俐 義 膜 縣 
返=回 校 鄉 工 青 潮 抵 國 還 修 照 利 程 場 城 航 防 崗 歸 聘 貧 遷 俗 身 銷 祖 租 
污=穢 濁 染 點 泥 蔑 水 垢 毒 漬 的 跡 物 吏 痕 名 損 油 
崩=潰 裂 塌 盤 龍 漏 落 坍 癥 壞 解 
赤=膊 腳 足 子 貧 金 誠 道 心 著 土 豆 峰 痢 字 忱 縣 磷 柱 裸 壁 色 身 鹿 露 熱 背 潮 地 膽 紅 眉 水 芍 松 手 城 日 體 楊 
飽=滿 和 受 足 覽 餐 的 食 暖 嘗 讀 含 嗝 經 學 雨 蘸 
佳=人 節 作 話 句 麗 偶 音 稱 品 肴 境 婿 績 能 釀 景 期 美 妙 日 縣 
慨=嘆 然 允 
抄=襲 寫 本 錄 來 的 報 收 下 書 家 查 道 獲 件 沒 送 身 手 用 
熊=掌 貓 市 的 樣 包 膽 蹯 琪 本 蜂 皮 
務=必 求 須 農 使 實 虛 請 工 要 正 本 川 
擦=拭 傷 身 網 鞋 過 粉 干 去 肩 掉 亮 邊 汗 黑 痕 破 洗 音 澡 出 除 刮 凈 臉 抹 熱 上 藥 油 著 子 
銷=路 售 毀 戶 到 贓 量 貨 往 魂 案 場 釘 假 蝕 勢 鑠 行 賬 子 金 煙 
購=買 置 樓 物 入 票 并 得 貨 回 房 書 進 車 銷 股 價 機 料 
吞=沒 噬 吐 食 并 服 滅 下 吃 咽 剝 掉 金 聲 蝕 占 
閻=王 羅 
耀=眼 目 斑 縣 祖 
寺=院 廟 僧 觀 主 
澳=洲 門 元 抗 
筐=子 
驢=子 肉 騾 叫 
簽=字 名 訂 子 筒 約 證 到 呈 署 發 收 上 單 批 條 押 注 章 準 
尺=寸 牘 度 子 碼 蠖 骨 素 頭 頁 
贏=得 球 取 家 了 棋 定 面 方 回 
率=領 直 真 先 由 性 兵 部 然 隊 團 
奚=落 
纏=綿 繞 身 著 擾 住 在 上 結 人 綁 磨 手 足 斗 裹 腳 緊 
淪=陷 為 落 亡 喪 沒 
術=語 科 后 前 士 
吱=聲 嘎 呀 叫 
鬧=翻 事 鐘 市 騰 戲 劇 著 得 出 病 鬼 了 心 熱 場 房 哄 荒 架 氣 天 災 賊 鈴 區 
侍=候 女 者 奉 郎 從 衛 弄 立 魂 養 仆 童 婢 
融=化 合 洽 解 資 入 和 匯 通 會 為 雪 
唧=噥 筒 
拯=救 民 
泄=露 氣 漏 憤 恨 勁 底 密 火 洪 水 瀉 出 欲 
窒=息 礙 
咬=牙 破 牙 傷 著 人 住 字 緊 死 定 合 群 舌 她 嘴 的 掉 斷 過 碎 下 
啼=哭 明 笑 叫 鳴 泣 聲 
矗=立 
殖=民 
棕=色 櫚 樹 繃 繩 黃 紅 黑 毛 熊 
旺=盛 角 季 市 銷 鋪 年 火 發 健 勢 月 
寢=室 食 具 車 宮 
瞌=睡 
翡=翠 
悔=恨 過 悟 罪 改 棋 意 婚 約 
換=取 班 人 錢 洗 防 鞋 件 好 氣 算 文 上 來 新 句 成 購 個 手 過 到 回 季 屆 掉 得 親 羽 心 車 匯 出 裝 發 下 棋 號 行 膚 乘 茬 代 擋 房 貨 崗 工 肩 馬 帖 血 向 牙 藥 樣 筆 步 稱 燈 毛 起 球 去 水 速 位 頁 衣 用 油 喻 紙 
堡=壘 子 
頻=繁 率 道 密 次 寬 傳 譜 仍 帶 度 段 
闊=氣 綽 別 步 少 達 佬 人 野 大 
榕=樹 
蕭=條 薔 瑟 索 邦  
嘻=
晶=瑩 體 圓 核 軸 石 亮 格 粒 面 片 態 
簇=擁 新 生 葉 
晃=動 蕩 點 悠 眼 
兇=惡 手 猛 殘 狠 險 暴 犯 橫 器 悍 兆 焰 案 殺 宅 年 服 耗 光 狂 氣 神 煞 死 事 頑 相 信 嫌 
畏=懼 縮 途 友 罪 難 避 光 忌 怯 葸 水 
澄=清 明 碧 澈 凈 清 瑩 海 江 邁 
雷=聲 雨 鋒 霆 公 電 動 擊 轟 達 暴 諾 同 鳴 鳥 池 場 害 管 波 恩 根 汞 龍 劈 區 山 神 州 
頌=揚 歌 詞 德 辭 詩 楊 
啤=酒 
募=捐 集 款 兵 化 股 
熄=滅 燈 火 減 
懼=怕 色 內 
俊=俏 美 秀 杰 彥 男 偉 朗 才 氣 士 逸 雅 峰 
碩=士 果 大 鼠 
嘔=吐 心 出 血 
餞=行 別 
盜=賊 竊 匪 賣 鏈 了 案 墓 用 版 取 伐 獵 汗 掘 劫 魁 運 印 車 壘 領 走 
卷=子 入 兒 進 曲 煙 紙 軸 筒 尺 須 宗 標 二 起 動 繞 次 發 面 逃 云 揚 帙 材 成 過 積 緊 毛 上 舌 縮 走 
墓=碑 志 地 穴 表 道 園 葬 碣 祭 門 室 塋 
瀑=布 
芳=草 香 澤 菲 齡 心 名 醇 蹤 華 容 鄰 年 馨 姿 村 烴 
蹤=跡 影 
躍=進 然 升 居 上 起 馬 動 遷 增 過 入 
琉=璃 球 
逗=留 笑 人 樂 點 號 弄 了 她 他 哏 趣 引 惹 
蓬=松 萊 亂 勃 茸 蒿 散 安 溪 蓽 
鼾=聲 睡 
垂=死 柳 釣 涎 直 青 范 體 線 詢 下 危 手 足 愛 淚 老 憐 念 簾 落 掛 拱 暮 盼 首 髫 頭 問 懸 楊 成 度 顧 心 
枯=燥 枝 萎 草 樹 葉 寂 竭 瘦 澀 藤 井 干 槁 朽 骨 死 黃 榮 腸 涸 焦 窘 木 水 坐 
蟲=子 鳴 蟻 牙 害 草 眼 災 卵 在 膠 口 癭 豸 類 聲 蛀 
巷=子 戰 道 口 陌 議 
軌=道 跡 度 距 轍 枕 
刪=改 節 除 了 去 減 掉 帖 詞 號 略 汰 削 
升=官 學 天 降 高 級 騰 華 格 遷 位 旗 至 幅 勢 跌 上 值 到 起 為 職 空 任 班 檔 溫 序 水 平 入 技 力 沉 調 發 冪 級 堂 限 壓 漲 帳 汞 麻 速 
廉=價 恥 潔 政 頗 明 正 直 江 售 者 
宅=門 子 院 第 心 電 邸 地 基 舍 
醞=釀 
苗=條 族 子 圃 頭 寨 床 期 栗 兒 劇 家 木 情 繡 鄉 裔 語 豬 人 芽 種 
涵=養 洞 蓋 閘 容 渠 
違=背 反 抗 法 犯 建 禁 例 規 約 逆 紀 者 章 憲 拗 令 礙 和 忤 誤 迕 心 
齷=齪 
烹=調 飪 制 茶 
筋=斗 肉 骨 絡 脈 節 道 
晨=光 星 暉 跑 練 報 曦 曲 操 昏 炊 風 霧 禱 間 露 衣 鐘 
燭=光 臺 花 淚 火 照 蕊 心 
恩=惠 怨 人 典 情 賜 德 澤 來 寵 愛 仇 平 師 公 義 遇 準 施 
焰=火 口 心 
瓦=礫 片 匠 解 斯 房 盆 屋 爾 塊 工 楞 當 松 特 藍 剌 亮 壟 刀 灰 罐 圈 全 頭 器 窯 
牽=連 牛 涉 扯 掛 引 制 動 強 累 線 掣 住 出 絆 頭 著 手 起 念 纏 記 系 來 伸 索 
吝=嗇 惜 色 
匈=奴 
芭=蕉 蕾 比 拉 
苛=刻 求 責 捐 政 察 待 評 雜 細 
丁=香 卯 亥 丑 零 男 壩 部 醇 點 艱 克 稅 烷 烯 憂 壯 典 基 醛 炔 酸 酮 
毒=藥 蛇 害 辣 手 氣 刑 品 草 計 物 蟲 打 化 素 箭 酒 霸 汁 劑 菌 餌 瘤 性 液 的 販 癮 針 梟 死 犯 案 詞 刺 謀 殺 霧 腺 蕈 資 蛾 力 芹 牙 質 
芍=藥 
須=要 發 生 子 知 在 由 向 經 有 先 將 按 與 留 根 臾 鯨 眉 看 彌 
雇=用 員 工 傭 主 請 農 人 車 兇 
項=羽 目 鏈 圈 背 城 飾 
姻=緣 親 婭 
潺=
娼=妓 婦 門 
坎=肩 坷 兒 子 
豬=肉 玀 肝 油 仔 籠 排 食 蹄 草 場 皮 崽 鬃 頭 腳 苓 欄 肚 獾 倌 苗 圈 舍 瘟 娃 狗 尾 嘴 
畸=形 胎 戀 變 
綏=遠 靖 濱 德 化 江 寧 陽 中 
席=子 面 卷 次 地 位 上 間 草 棚 勒 篾 
降=低 生 臨 落 格 入 溫 魔 香 級 溫 至 到 下 價 為 雨 幅 福 班 解 伏 火 服 息 水 脂 塵 耗 將 旗 順 速 雪 序 薪 壓 職 噪 表 冪 妖 旨 
戶=口 外 頭 主 籍 內 數 名 均 庭 限 型 牖 長 部 
銳=利 敏 氣 化 意 角 減 增 步 
吐=露 血 沫 蕃 出 痰 絮 翠 話 口 氣 棄 實 穗 絲 訴 瀉 泄 艷 字 納 蕊 司 
菜=蔬 館 園 單 刀 市 飯 場 花 肴 葉 地 籃 圃 色 根 鳥 農 豆 油 瓜 窖 式 譜 鳥 心 價 案 牛 霸 幫 點 店 蕻 金 品 票 畦 青 區 帖 薹 攤 苔 系 羊 籽 田 蚜 種 
棗=樹 子 紅 糕 泥 兒 茶 木 莊 花 強 陽 
簌=
幌=子 
溜=走 光 出 滑 號 冰 達 了 轉 兒 邊 槽 門 平 圓 桌 子 掉 過 進 去 須 
拌=嘴 勻 種 和 蒜 面 著 
浩=蕩 劫 大 繁 方 氣 然 瀚 渺 茫 嘆 特 
亮=光 堂 相 相 麗 起 度 出 了 燈 點 兒 丑 底 短 分 話 富 牌 色 
玉=蘭 石 米 器 色 簪 樹 女 鐲 帛 雕 照 兔 佩 溪 皇 璽 山 手 龍 成 帝 人 立 容 帶 環 佛 潔 麥 盤 碎 體 液 顏 堂 屑 葉 峰 門 瓶 泉 璧 
炎=熱 黃 涼 夏 癥 功 日 帝 暑 陽 
躺=椅 在 臥 著 下 倒 柜 
籬=笆  落 柵 
邁=步 進 出 向 入 開 拓 上 過 克 
顴=骨 
橡=皮 膠 樹 實 木 子 
娶=親 個 妻 
爵=士 位 祿 
龍=頭 船 燈 舟 井 眼 王 套 蝦 宮 洞 種 陽 須 芯 崗 丹 袍 骨 膽 門 年 珠 虎 鳳 騰 山 華 潭 女 馬 泉 飛 文 齒 床 堌 口 葵 三 庭 體 舞 顏 族 鐘 兒 城 川 海 江 駒 脈 腦 蛇 身 紋 溪 巖 吟 游 州 
壽=星 命 衣 材 桃 面 禮 數 險 木 聯 斑 司 山 辰 誕 酒 堂 穴 筵 終 光 寧 縣 宴 
攝=影 取 制 氏 像 錄 入 理 生 食 衛 行 政 動 
捏=造 合 住 弄 積 成 緊 碎 
膨=脹 體 大 化 
凸=出 起 鏡 版 顯 輪 凹 面 現 邊 窗 角 緣 狀 
塊=兒 根 煤 狀 壘 莖 頭 菌 
囚=犯 禁 徒 車 牢 室 衣 鳥 籠 房 人 
捐=款 獻 助 贈 稅 出 血 給 錢 資 軀 輸 建 棄 物 
遼=闊 遠 寧 沈 金 東 河 西 陽 源 代 國 中 
鋒=利 芒 刃 線 銳 鏑 快 面 頭 
攪=亂 動 成 拌 和 勻 得 擾 鬧 纏 渾 混 局 炒 打 翻 合 
昂=然 首 貴 揚 達 藏 奮 起 
陡=然 坡 峻 直 峭 立 變 壁 起 險 崖 增 的 度 
雅=人 致 興 座 號 趣 量 思 意 虎 典 麗 苑 各 俗 士 集 尼 安 樂 淡 觀 教 靜 潔 氣 馴 相 言 譽 正 丹 稱 芳 事 琪 
抹=殺 布 黑 去 掉 上 臉 零 彩 搭 粉 面 胸 澡 子 除 刀 灰 平 頭 
誕=生 辰 
肢=體 解 勢 
閣=下 樓 員 僚 揆 外 
駐=扎 防 軍 守 區 兵 港 華 外 足 地 京 美 滬 留 蹕 屯 波 顏 
哨=子 兵 棒 房 卡 所 位 音 聲 
擅=長 自 闖 于 用 入 權 離 
扔=掉 出 在 到 進 錢 棄 下 了 回 來 去 
咚=
潛=伏 在 逃 藏 入 力 心 到 水 流 熱 艇 能 質 龍 泳 匿 航 居 虧 行 蹤 江 鳥 山 游 
攙=扶 和 住 
幕=后 府 布  僚 前 賓 友 間 
肅=靜 清 穆 立 反 貪 然 殺 寧 
衡=量 陽 山 器 水 東 南 
丞=相 
拾=遺 掇 取 柴 貝 零 起 回 到 趣 得 貳 陸 荒 玖 柒 ? 肆 物 伍 壹 
弊=病 端 害 政 
候=補 車 鳥 審 選 診 機 船 場 光 教 缺 溫 復 
盧=布 比 
霸=道 占 王 權 主 氣 業 持 
緬=甸 懷 因 邈 想 
邪=惡 氣 說 念 財 魔 心 道 祟 行 路 教 淫 術 乎 火 門 僻 
灌=溉 輸 木 注 籃 圖 水 漿 錄 頂 水 入 腸 區 音 制 裝 進 南 洗 云 醉 
咽=喉 氣 頭 炎 下 
蘭=花 州 草 新 亭 譜 嶼 章 考 陵 溪 
倉=庫 促 頡 儲 鼠 皇 廩 容 房 位 單 
揣=摩 測 度 想 著 
掛=念 鐘 歷 號 名 燈 面 牌 彩 鉤 帥 畫 牽 包 圖 表 屏 零 懷 靠 毯 在 著 上 了 心 勾 起 慮 滿 斷 職 接 掉 礙 累 鐮 漏 鞭 車 齒 鋤 斗 擋 單 花 火 紅 冠 果 級 機 記 甲 件 拍 欠 旗 失 鎖 靴 孝 賬 軸 出 到 得 架 簾 入 
蝸=牛 桿 輪 居 旋 
筵=席 宴 
咆=哮 嘯 
哄=笑 騙 鬧 傳 勸 然 弄 人 逗 搶 抬 誘 
醬=油 肉 菜 色 園 紫 瓜 汁 坊 
錢=財 莊 包 糧 幣 箱 票 夾 袋 多 途 鈔 褡 谷 柜 款 數 物 眼 租 塘 鼠 
仁=慈 愛 義 兄 政 厚 弟 心 德 和 道 果 布 壽 子 
霍=地 亂 金 爾 然 閃 都 城 山 
抖=動 擻 摟 落 顫 出 開 
碴=兒 口 
蝙=蝠 
射=擊 雕 速 線 手 程 入 箭 門 出 中 殺 向 精 影 進 了 頻 獵 流 電 界 穿 彈 干 洪 來 陽 魚 源 
貼=近 補 金 心 切 住 滿 好 現 邊 水 題 士 上 身 紙 在 有 出 圖 息 到 兜 畫 換 合 己 緊 面 譜 錢 權 片 
勁=頭 敵 旅 歌 舞 升 爆 力 拔 吹 草 風 健 射 松 頭 道 兒 
詼=諧 
柏=油 樹 楊 木 林 含 枝 
徽=章 號 州 標 菜 記 劇 墨 縣 
怔=忡 
截=住 斷 然 至 取 了 止 擊 獲 稿 口 流 圖 留 標 面 門 收 癱 子 肢 距 去 頭 尾 
婉=轉 言 約 嫻 拒 君 麗 辭 和 順 謝 
梆=子 硬 
套=子 話 間 數 筒 房 用 語 鞋 印 圖 褲 曲 版 裝 購 色 餐 現 票 件 在 種 上 利 路 管 牢 取 服 圈 衫 匯 書 瓷 犁 裁 車 紅 改 耕 馬 裙 問 袖 作 磁 包 接 索 頭 住 
淵=博 源 深 藪 海 默 泉 
冗=長 員 雜 筆 繁 務 余 贅 詞 官 言 語 
宏=大 偉 愿 論 遠 觀 達 圖 基 業 興 麗 恩 博 才 富 闊 贍 旨 構 量 仁 儒 毅 謨 
觸=動 犯 及 覺 須 角 電 礁 發 手 摸 到 目 碰 怒 感 機 媒 殺 痛 網 板 底 點 擊 毛 診 
挪=動 威 用 作 到 借 窩 移 開 
碾=坊 子 場 米 盤 平 碎 砣 磨 壓 
漱=口 
俱=備 全 佳 
魄=力 
艷=麗 史 裝 情 色 女 詩 服 陽 紅 羨 福 美 舞 遇 冶 妝 歌 事 俗 
霹=靂 雷 
怯=懦 弱 陣 場 步 生 
渲=染 
吟=詩 哦 唱 誦 詠 出 游 
漩=渦 
賀=喜 年 詞 禮 信 電 聯 幛 卡 歲 龍 函 儀 功 蘭 匾 
肖=像 鷹 敏 邦 
逍=遙 
盈=虧 余 利 滿 通 門 溢 江 眶 
餐=桌 館 廳 具 臺 車 巾 會 飲 后 券 點 費 室 位 紙 布 刀 椅 
勻=稱 整 凈 臉 溜 兌 和 速 實 出 調 
橄=欖 
跑=馬 步 外 車 道 圈 鞋 到 去 了 出 得 來 過 進 掉 遍 向 著 動 路 壘 表 調 電 刀 肚 光 官 街 開 氣 墑 題 腿 堂 位 轍 程 速 下 走 
噩=夢 耗 運 兆 
蔑=視 稱 
歧=視 路 途 異 黃 見 義 出 化 管 
祭=祀 壇 祖 文 品 灶 奠 禮 掃 拜 器 臺 司 物 天 典 酒 日 
窺=探 見 伺 視 測 孔 看 察 度 破 望 
浸=透 潤 入 漬 泡 染 會 在 禮 種 軟 淫 洗 水 沉 沒 濕 出 過 劑 溶 蝕 液 
塑=造 像 料 封 鋼 膠 身 性 成 化 
偽=裝 善 造 軍 幣 鈔 書 證 冒 稱 品 足 劣 飾 托 作 的 經 誓 
林=子 木 立 海 地 葉 邊 區 場 帶 業 中 肯 家 學 火 齡 蔭 間 冠 農 彪 產 叢 沖 分 壑 墾 莽 檎 泉 藪 申 濤 網 下 相 型 苑 稹 政 丹 甸 口 特 西 縣 野 芝 周 
續=編 集 費 傳 斷 借 約 篇 聘 簽 建 訂 保 讀 貂 航 假 娶 弦 完 
險=惡 些 峻 阻 灘 要 境 象 情 詐 癥 勝 別 遭 地 堤 隘 路 段 峰 乎 關 固 工 絕 區 球 事 性 韻 種 兆 
秧=歌 子 田 苗 齡 
烘=托 干 烤 籠 爐 焙 染 籃 襯 箱 板 制 
頃=刻 
辱=罵 沒 命 
販=賣 子 毒 運 私 到 黃 夫 非 假 
涂=抹 改 布 上 鴉 在 層 料 白 凌 畫 繪 片 飾 刷 色 炭 寫 乙 掉 粉 敷 黑 膠 蠟 滿 漆 去 油 脂 
泡=沫 影 菜 水 上 尿 面 酒 湯 飯 桐 茶 在 妞 吧 澡 貨 饃 糖 紗 堂 網 子 疹 
晦=氣 澀 暗 冥 明 暝 朔 
贈=送 品 禮 言 書 閱 券 予 給 與 別 答 金 款 物 票 以 
洞=穴 口 房 悉 簫 察 窟 見 內 里 庭 穿 徹 達 府 開 天 曉 子 頭 燕 
儲=蓄 藏 備 存 值 量 錢 水 運 戶 放 積 集 金 君 油 
宛=轉 然 如 若 似 城 
簿=子 冊 記 籍 
潦=草 倒 
扶=持 梯 手 助 桑 植 養 貧 起 疏 正 鸞 弱 病 殘 風 乩 搖 掖 下 壁 溝 過 余 直 
壟=斷 溝 作 坎 
乳=房 母 名 香 頭 酪 汁 搖 罩 臭 兒 缽 牛 癌 鴿 液 膠 豬 粉 酸 化 腺 暈 類 品 齒 娘 白 畜 腐 黃 峰 劑 糜 糖 牙 油 燕 脂 溝 漿 酒 山 業 狀 
敗=壞 仗 北 落 者 露 類 筆 績 將 寇 陣 訴 給 在 亡 局 走 于 兵 毒 火 果 家 軍 退 胃 興 象 謝 絮 因 葉 子 德 逃 
廬=山 江 舍 
礙=事 眼 于 難 口 手 
廳=堂 房 內 事 長 級 局 外 
慫=恿 
郁=悶 積 熱 結 怒 芳 憤 氣 血 悒 閉 江 南 友 
岔=子 道 路 口 流 換 開 氣 
兀=自 傲 立 然 鷲 禿 突 
蝌=蚪 
托=付 盤 福 派 詞 子 故 腮 運 管 人 庇 住 起 兒 板 架 大 病 辦 缽 底 孤 舉 疾 夢 名 腔 生 身 熟 收 幼 稱 克 里 馬 
裂=開 縫 痕 紋 口 變 璺 隙 化 果 谷 解 片 罅 
妯=娌 
賄=賂 選 買 款 金 
竅=門 
漠=然 視 北 河 
獵=人 取 戶 犬 狗 槍 物 場 裝 鹿 殺 鷹 捕 豹 刀 獲 具 奇 手 食 頭 艷 馬 鳥 
愁=容 緒 苦 思 腸 城 楚 煩 懷 悶 眉 云 
搪=塞 瓷 
撕=碎 下 破 開 毀 爛 邊 裂 票 掉 扯 咬 
檀=香 木 板 越 郎 
凱=旋 歌 特 利 撒 莉 里 普 茜 
置=身 于 辦 備 換 業 評 之 入 放 信 頂 喙 買 閏 
盆=子 景 栽 地 花 腔 湯 浴 
誹=謗 
查=考 禁 辦 看 問 明 封 訪 賬 抄 究 點 驗 無 號 分 證 勘 詢 哨 收 閱 處 獲 清 對 找 核 出 理 實 到 鋪 了 案 過 尋 檢 緝 表 殺 擺 毒 堵 檔 房 崗 繳 截 扣 控 票 勤 私 稅 體 巡 夜 照 拳 遍 錯 音 知 字 
咯=吱 ? 血 聲 笑 
艙=面 位 門 口 蓋 底 內 
聘=請 書 禮 約 金 任 用 為 期 問 
崎=嶇 
噴=嚏 泉 射 發 香 壺 藥 施 繪 畫 血 吐 漆 氣 頭 墨 霧 出 涂 水 燈 流 撒 灑 上 槍 火 薄 鍍 糞 飯 放 灌 管 濺 漿 口 殺 桶 瀉 涌 嘴 子 淋 砂 濕 
餛=飩 
慣=用 例 性 技 賊 偷 常 了 于 溺 稱 盜 犯 匪 家 騙 竊 縱 壞 有 
笨=重 拙 蛋 豬 鳥 的 伯 貨 瓜 人 
眷=屬 戀 顧 念 愛 注 
蔬=菜 食 果 
酋=長 
嘟=噥 嚕 囔 
岳=父 母 家 丈 廟 陽 飛 池 西 云 
恬=靜 淡 適 然 美 謐 
炯=然 
拙=劣 笨 作 著 筆 見 樸 澀 荊 
栽=培 種 下 贓 植 樹 倒 絨 插 花 秧 子 了 桑 誣 
翩=然 躚 
掏=錢 牌 出 空 糞 底 心 槽 
巫=師 術 峽 女 婆 山 神 醫 
措=施 辭 大 詞 辦 美 手 意 置 
潤=濕 色 物 筆 滑 飾 澤 膚 肺 喉 例 腸 格 資 身 
蘆=葦 花 席 柴 根 筍 笙 薈 蕩 竹 笛 山 蕪 
撰=寫 稿 述 著 文 
貿=易 然 
桐=油 子 樹 柏 城 廬 鄉 梓 
島=嶼 國 上 中 內 民 弧 礁 城 外 
諺=語 
捕=捉 獲 殺 頭 食 魚 鯨 撈 獵 快 拿 手 鼠 蟹 
棒=子 冰 槌 球 糖 打 料 瘡 操 喝 殺 針 頭 
茍=安 同 且 存 活 合 簡 全 延 
魚=翅 肉 蝦 池 鱗 缸 類 子 肚 蟲 粉 雷 龍 塘 鮮 鷹 凍 油 餌 秧 兒 湯 尾 頭 骨 貫 道 片 竿 排 群 卵 白 鰾 刺 艙 唇 叉 籪 花 貨 鉤 干 膠 口 苗 漂 皮 情 水 松 汛 雁 躍 種 販 狗 籃 梁 腮 臺 
映=出 照 射 襯 日 在 像 紅 入 帶 現 雪 
搏=斗 擊 動 殺 戰 
刑=罰 場 具 事 法 名 律 訊 期 警 辱 部 房 庭 偵 種 書 
刮=風 出 開 起 目 臉 刀 倒 宮 痧 油 匙 掉 痕 了 去 須 
咕=嚕 噥 隆 嘟 咚 叨 唧 
籍=貫 
嘩=變 然 啦 眾 地 笑 
嗶=嘰 
賽=馬 跑 揚 出 車 事 后 前 程 道 場 會 季 期 區 段 地 過 況 球 情 艇 制 船 風 格 狗 特 
撲=滅 面 克 空 打 騰 在 殺 倒 街 粉 救 向 鼻 棱 臉 跌 地 火 擊 滿 閃 扇 簌 通 減 來 嚕 
囡=
吼=聲 叫 
晌=午 飯 覺 
庶=務 人 民 母 幾 出 乎 子 
嗤=笑 
炫=耀 目 弄 麗 示 鬻 
債=主 務 權 戶 款 券 額 利 
瞄=準 向 
蓋=子 章 起 臉 棺 上 印 過 茨 了 有 頂 頭 世 房 住 樓 簾 布 飯 火 帽 碗 銷 板 被 菜 成 掉 革 滿 瓦 
織=成 布 女 錦 物 田 機 造 工 補 品 染 花 就 邊 法 襪 
邦=交 國 聯 彥 
硬=朗 是 棒 化 木 漢 碰 性 殼 幣 塞 軟 碰 撼 直 派 仗 度 件 結 手 貨 玉 盤 的 要 筆 碟 驅 脂 塊 ? 板 逼 撐 頂 功 弓 繭 煤 面 拼 片 氣 說 傷 實 水 挺 糖 臥 席 座 掙 變 打 核 節 卡 鋁 起 體 推 質 
嫩=綠 葉 芽 草 白 苗 膚 的 滑 脆 黃 紅 生 江 枝 
狗=屁 熊 運 吠 肉 屎 寶 竇 獾 官 命 窩 咬 魚 才 洞 爬 皮 眼 蠅 
沮=喪 遏 洳 
碑=文 記 碣 帖 石 陰 志 銘 額 刻 林 廊 身 頭 亭 座 
獸=性 類 欲 醫 皮 行 環 群 王 心 疫 藥 化 窟 欄 窩 穴 脂 
扣=子 留 兒 下 動 光 點 頭 押 除 減 分 上 緊 著 住 薪 到 籃 肉 罰 發 將 繳 取 球 殺 題 壓 眼 錢 掉 環 牢 
茄=子 克 
劉=邦 昶 備 琦 歡 
米=飯 粉 粒 湯 價 色 面 酒 盧 店 蟲 膚 糠 蘭 勒 格 粥 爾 線 醋 倉 尺 袋 單 芾 黻 黃 行 雙 突 制 豬 糕 林 鋪 泉 市 脂 
察=看 覺 明 訪 驗 隅 院 
駙=馬 
憋=悶 氣 了 屈 死 住 
奧=妙 秘 運 迪 義 林 星 援 旨 姆 拓 
淮=南 河 海 北 劇 水 安 濱 陽 陰 
歪=曲 道 風 路 脖 了 理 扭 才 纏 斜 嘴 倒 門 詩 著 
兼=任 顧 并 課 備 職 管 辦 容 具 有 收 營 得 修 用 程 差 施 聽 祧 優 之 毫 治 
褐=色 煤 藻 斑 土 
茂=盛 密 名 林 年 
枷=鎖 
攀=談 登 親 折 附 比 升 緣 上 爬 高 巖 越 繞 扯 供 鋼 交 禽 到 樹 
乏=味 力 人 困 煤 汽 術 
炊=煙 事 具 帚 
蔓=延 草 生 菁 
鯉=魚 
臃=腫 
麥=子 田 穗 片 秋 苗 秸 浪 芒 芽 茬 冬 收 加 克 麩 納 粒 蛾 草 蒂 垛 稈 糠 客 口 莛 種 鯨 城 道 地 管 角 精 酒 蚜 粥 
靴=子 形 
餑=
脈=搏 絡 息 沖 動 案 理 門 象 枕 波 管 礦 石 壓 
毆=打 辱 斗 傷 
吹=動 牛 拂 噓 打 風 捧 皺 落 盡 奏 襲 得 來 氣 起 過 的 笛 干 散 走 響 號 管 入 出 擂 燈 進 開 拍 腔 彈 臺 倒 掉 斷 火 樂 滅 哨 送 塑 熄 簫 
鬢=發 角 毛 
膩=煩 蟲 味 人 歪 友 子 
禍=害 事 患 首 根 胎 祟 端 亂 殃 心 福 及 水 種 
屹=立 然 
翰=林 墨 海 
痙=攣 
緘=默 口 
婢=女 
杏=仁 黃 子 紅 花 林 里 干 脯 樹 眼 
瑟=縮 
踏=實 板 青 步 平 歌 入 上 足 出 進 著 遍 看 錯 過 浪 春 訪 空 勘 雪 級 碎 
貓=臉 眼 咪 王 撲 膩 步 熊 腰 魚 叫 科 皮 肉 
滲=透 入 漏 水 出 碳 進 析 流 溝 井 坑 渠 灌 過 量 濾 
纖=細 巧 弱 小 塵 維 毫 夫 苗 毛 體 腰 柔 長 繩 手 瘦 秀 長 度 密 悉 絲 
陛=下 
諱=言 忌 飾 
扼=要 住 殺 守 腕 制 
賦=予 稅 性 有 值 詩 閑 役 形 于 
框=子 架 在 定 圖 格 
帆=布 船 板 檣 具 影 桁 
鏟=除 子 兒 車 平 刀 起 土 雪 
擬=定 作 稿 議 訂 人 態 于 建 將 向 撥 為 辦 請 古 題 音 制 
窯=洞 坑 變 頂 姐 子 主 
馴=服 順 養 熟 馬 良 鹿 化 獸 
捷=徑 克 報 達 
賓=客 主 館 格 詞 朋 州 白 得 東 服 語 川 縣 陽 
謾=罵 
綿=羊 延 軟 密 紙 亙 綢 力 陽 掌 連 薄 長 和 糖 甜 遠 子 
稚=氣 嫩 子 弱 童 齡 
跋=涉 扈 文 語 
溝=通 壑 渠 底 槽 瀆 壕 塹 洫 床 里 鼠 沿 
履=行 歷 新 約 任 帶 
爪=牙 子 兒 哇 印 
窄=小 的 幅 帶 路 狹 
荔=枝 波 
扭=轉 曲 動 打 身 過 力 傷 虧 腰 捏 擺 扯 搭 斷 結 矩 送 頭 了 秤 倒 斗 絞 筋 緊 歪 彎 住 
拐=子 彎 杖 賣 角 棍 進 騙 棒 帶 點 棗 到 了 入 走 
穗=子 選 狀 
椰=子 菜 林 雕 棗 胡 蓉 樹 油 
渣=滓 子 人 打 土 
頒=布 發 證 行 獎 授 贈 給 予 
球=場 兒 賽 隊 形 門 員 拍 體 面 鞋 莖 狀 風 網 心 星 藝 癮 迷 類 手 衣 技 壇 王 桿 路 齡 操 膽 果 菌 褲 市 臺 棒 部 閥 根 棍 籍 衫 速 童 芽 桌 僮 
馳=騁 名 電 目 驅 書 突 援 譽 驟 過 念 去 
漁=船 家 夫 民 翁 村 舟 獵 網 場 歌 鼓 火 霸 利 業 人 港 輪 期 具 撈 農 產 叉 父 婦 戶 工 區 鄉 色 
匾=額 牌 文 
嘹=亮 
冠=軍 子 以 冕 群 帶 蓋 詞 捷 絕 禮 毛 名 縣 
網=球 袋 籃 絡 羅 兜 子 住 妖 齡 聯 費 段 編 文 巾 眼 狀 綱 膜 頁 站 上 址 友 際 吧 民 中 域 內 點 通 名 管 景 捕 孔 路 外 易 卡 游 盤 速 戀 蟲 關 哥 警 姐 迷 壇 窩 校 線 箱 罟 大 格 架 間 扣 里 目 神 絲 魚 員 罩 
凜=然 冽 
鋤=頭 禾 把 草 地 奸 
橢=圓 球 
輔=助 導 佐 以 仁 幣 音 料 業 路 弼 ? 食 修 
虱=子 
啞=巴 謎 劇 鈴 子 然 女 場 彈 火 炮 語 的 
惜=別 力 時 敗 福 售 陰 
烙=餅 印 鐵 下 花 制 
腹=部 稿 地 瀉 心 腔 中 痛 板 鳴 脹 肌 內 案 非 誹 面 膜 水 議 背 壁 語 
炒=菜 面 米 高 掉 得 了 勺 作 股 賣 家 飯 樓 至 風 熟 蛋 螺 房 匯 貨 肝 更 鍋 買 郵 族 
扁=擔 豆 柏 骨 平 率 嘴 食 桃 圓 舟 長 鵲 鐵 蓄 
斬=將 獲 斷 首 倉 殺 
蠕=動 蟲 行 
謳=歌 吟 
逛=蕩 街 燈 游 一 
袒=護 露 著 
旬=刊 日 報 陽 邑 
茯=苓 
蔥=綠 郁 白 花 蘢 蓮 翠 姜 茂 蒜 頭 
奪=取 位 來 得 魁 占 標 冠 去 金 目 回 走 權 過 人 下 路 杯 魂 
焚=燒 毀 化 香 風 書 
藐=視 
迢=遠 遙 遞 
恫=嚇 嚇 
錦=繡 緞 旗 州 標 袍 雞 囊 華 西 江 屏 綸 葵 衣 城 濤 霞 
鯽=魚 
斥=責 罵 資 力 地 候 革 賣 退 問 逐 
腸=子 胃 炎 癌 管 道 斷 壁 鳴 液 衣 線 
鍋=子 蓋 灶 爐 貼 碗 巴 臺 餅 鏟 底 伙 盔 莊 垢 里 
贖=罪 金 買 回 當 身 
寵=愛 兒 信 壞 物 幸 溺 慣 用 
斑=駁 點 白 鳩 竹 馬 紋 痕 禿 斕 塊 鶇 蝥 疹 巖 
蘊=藏 藉 含 涵 結 蓄 積 
偌=大 
漏=洞 網 子 斗 水 人 稅 壺 勺 風 光 了 夜 電 油 出 報 面 氣 掉 窗 兜 檢 判 失 脫 泄 診 卮 嘴 池 處 接 孔 誤 下 雨 
妙=法 處 計 語 策 藥 趣 哉 喻 文 答 傳 境 訣 手 齡 用 方 想 論 女 麗 筆 品 算 招 著 舞 極 曼 
覆=蓋 轍 沒 滅 上 舟 被 土 亡 
壕=溝 塹 
呱=叫 嗒 唧 
罕=見 有 聞 用 事 
腿=腳 帶 部 上 勤 子 肉 
摘=錄 取 要 抄 心 得 了 發 引 記 編 除 自 下 報 登 桂 借 帽 牌 譯 由 走 出 掉 花 來 去 
翠=綠 竹 鳥 玉 柳 花 園 華 菊 藍 柏 屏 色 微 娥 珠 
嗩=吶 
嬌=嫩 小 艷 羞 貴 憨 媚 氣 柔 癡 娃 容 嬈 客 慣 妻 美 弱 娘 兒 女 寵 嗔 好 聲 態 養 縱 喘 怯 軀 
綁=票 架 匪 定 帶 緊 住 著 縛 腿 扎 
俯=視 瞰 仰 沖 伏 身 首 拾 念 察 角 就 拍 臥 允 看 曲 下 
酣=睡 暢 夢 戰 然 眠 甜 飲 醉 
凍=死 結 瘡 僵 兒 肉 害 餒 冰 傷 土 雨 原 災 瘃 糕 壞 裂 
彈=性 子 藥 簧 劾 詞 丸 弓 坑 片 回 起 力 射 道 殼 頭 珠 跳 倉 唱 體 到 指 出 夾 痕 孔 壓 雨 腿 淚 撥 琴 奏 箏 幕 
醉=意 鬼 眼 漢 的 翁 鄉 態 酒 人 心 倒 了 話 拳 蟹 棗 
蚯=蚓 
駕=馭 駛 車 到 臨 照 凌 齡 崩 機 校 轅 船 
谷=子 物 地 雨 底 城 類 粒 倉 草 口 殼 米 苗 穗 歌 堆 關 糠 音 
簍=子 
訣=別 竅 要 
菠=菜 蘿 
豌=豆 
褻=瀆 衣 玩 慢 
樵=夫 
瘧=疾 蚊 子 
奏=樂 效 折 章 鳴 響 疏 出 起 本 捷 凱 議 
凌=亂 辱 晨 駕 空 厲 志 霄 波 云 轢 人 虐 遲 侮 汛 夷 雜 錐 源 
源=泉 流 頭 地 自 于 碼 點 
沾=染 滿 光 邊 到 上 污 濕 有 親 手 襟 衣 恩 化 
族=人 長 類 譜 規 權 群 裔 
芙=蓉 蕖 
窈=窕 
沈=陽 凌 冰 暢 泓 括 淪 醉 默 丘 
僵=硬 尸 局 持 死 蠶 化 冷 臥 直 
囈=語 
溺=愛 水 死 嬰 職 
褒=貶 獎 揚 詞 賞 稱 義 譽 
霞=光 帔 冠 彩 浦 石 
烽=火 煙 燧 
詭=計 詐 辯 秘 異 譎 稱 誕 怪 奇 
迄=今 
俠=客 侶 女 骨 義 氣 士 
港=口 幣 灣 澳 行 汊 商 務 元 島 人 大 臺 府 股 九 市 區 督 內 式 姐 星 客 埠 胞 紙 情 
猖=狂 獗 
潑=辣 婦 皮 墨 水 剌 賴 灑 污 掉 
測=量 驗 定 試 序 了 出 繪 算 光 知 度 得 評 速 報 查 產 候 估 距 控 探 溫 字 錘 高 力 流 深 向 
菲=薄 禮 材 敬 儀 酌 特 
諂=媚 笑 諛 
玄=妙 武 學 想 覽 機 孫 狐 乎 奘 關 奧 理 秘 青 虛 遠 寂 難 
爛=泥 熟 糊 的 仔 尾 漫 污 賬 醉 掉 貨 
磨=盤 難 坊 滅 刀 蹭 光 損 砂 成 工 具 快 煉 碎 合 礪 人 料 輪 床 叨 煩 耗 粉 房 嘰 面 墨 皮 扇 蝕 削 洗 牙 折 嘴 制 子 邊 掉 過 亮 平 破 去 石 細 圓 杵 
窘=迫 態 境 促 況 急 困 相 狀 
奸=商 細 臣 淫 詐 黨 污 猾 人 夫 雄 計 險 佞 情 邪 笑 殺 惡 婦 宄 徒 賊 狡 
琴=聲 師 書 鍵 瑟 鳥 弦 酒 馬 
猢=猻 
烤=鴨 肉 爐 盤 雞 得 了 箱 餅 架 的 電 火 麩 焦 煙 干 熟 魚 
濫=用 發 交 觴 殺 捕 調 伐 砍 墾 
徑=自 直 向 賽 流 庭 行 跡 距 
雀=斑 躍 巢 鷹 子 類 
咸=菜 陽 肉 魚 水 蛋 性 濕 豐 的 寧 淡 味 鹽 度 海 湖 宜 
割=斷 據 舍 愛 裂 地 脈 讓 傷 除 線 禮 開 下 去 肉 接 炬 棄 槍 切 席 治 草 稻 掉 離 破 取 絨 
嫦=娥 
嘿=
漲=價 落 風 潮 得 幅 跌 停 勢 了 到 的 水 紅 滿 
蛤=蟆 蜊 蚧 殼 
絡=紗 繹 合 線 
朱=砂 門 德 熹 聰 
蠢=事 笨 人 貨 物 材 動 驢 話 才 蛋 夫 豬 拙 
萎=縮 靡 落 蔫 黃 謝 
旱=煙 災 地 路 船 澇 傘 象 情 田 稻 井 年 冰 道 季 魔 橋 區 獺 
臘=月 梅 腸 肉 味 日 八 魚 
喳=
耕=種 地 耘 作 牛 畜 具 翻 田 讀 夫 織 者 犁 
墊=子 腳 在 被 補 款 付 底 層 支 板 背 高 肩 圈 片 圈 錢 資 布 步 襯 塊 木 盤 平 上 紙 座 
筒=子 裙 褲 瓦 夾 
氈=子 帽 房 包 靴 條 
酷=愛 刑 熱 虐 男 狗 兒 極 暑 烈 似 吏 龍 斃 寒 好 機 圖 肖 語 政 
癆=病 
填=補 寫 詞 房 平 鴨 表 報 充 上 滿 入 土 料 好 塞 飽 倉 堵 發 方 空 坑 權 筑 隙 有 裝 
貞=操 節 潔 德 女 子 烈 婦 觀 淑 
紗=窗 廠 燈 布 罩 帽 籠 網 櫥 錠 線 巾 帳 筒 
氫=彈 氣 鍵 化 酸 
倡=導 議 廉 辦 首 揚 言 優 儀 
摔=倒 打 角 跤 了 下 死 得 壞 破 到 掉 跌 斷 傷 碎 
坑=道 害 人 騙 口 木 農 井 蒙 殺 洼 子 洞 
滴=水 涕 血 下 落 瀝 漏 蟲 翠 答 定 灌 管 劑 出 流 注 
嘉=定 獎 勉 賓 陵 許 華 義 禾 良 慶 興 靖 祥 聯 山 善 蔭 音 應 魚 
宦=官 海 途 游 
溶=化 解 液 劑 入 于 合 洞 點 膠 蝕 血 巖 脹 質 媒 體 
簸=箕 籮 弄 蕩 動 
絆=倒 兒 腳 子 跌 住 
糜=爛 子 
紊=亂 流 
淑=女 嫻 儀 靜 珍 
膚=淺 色 泛 廓 
踉=蹌 
蛐=兒 
披=散 露 肩 掛 風 甲 上 頭 著 巾 覽 瀝 紅 懷 卷 靡 屋 閱 蓋 
仄=聲 
澆=水 灌 注 滅 制 筑 漓 薄 灑 頭 鑄 地 花 口 
斧=頭 子 柯 削 削 鉞 鑿 整 正 柄 
蜂=王 蜜 群 房 窩 巢 糕 擁 鳴 脾 乳 箱 后 蠟 鳥 農 毒 猴 聚 膠 起 腰 
沐=浴 恩 
踴=躍 
惴=栗 
棋=子 盤 手 譜 藝 賽 迷 類 局 王 牌 路 布 風 枰 圣 壇 苑 友 聯 院 
僑=胞 民 居 鄉 商 務 界 匯 資 聯 辦 眷 屬 報 團 
劈=柴 去 臉 頭 開 叉 刺 刀 面 殺 手 胸 賬 材 成 裂 
鐮=刀 
繞=道 彎 嘴 遠 圈 過 著 舌 月 行 在 路 場 射 線 組 成 回 開 梁 轉 
蹩=腳 
貝=殼 司 隆 母 爾 克 斯 類 利 勒 寧 雕 多 書 子 蒂 拉 莎 塔 
鎖=鏈 掉 鑰 眼 骨 定 匙 上 住 緊 好 門 了 邊 國 眉 帖 頭 匠 孔 
檸=檬 
冥=界 想 王 暗 幣 鈔 府 茫 器 壽 思 頑 衣 
裊=繞 娜 
榨=取 菜 油 出 渣 汁 
榆=樹 莢 錢 林 木 社 
哇=靠 塞 ? 啦 叫 聲 
謬=誤 論 種 傳 錯 獎 說 
夭=折 矯 亡 
拇=指 戰 
豹=子 貓 
棚=子 架 屋 車 戶 房 圈 舍 
劊=
釀=成 酒 造 出 制 蜜 ? 
貫=穿 串 徹 通 注 標 口 休 眾 
蠶=豆 食 桑 蛹 眠 絲 子 卵 種 蛾 農 箔 繭 沙 山 蟻 紙 室 
怠=工 慢 惰 忽 職 
蜈=蚣 
蘑=菇 
均=衡 勻 分 好 勢 有 可 為 由 已 在 能 不 獲 需 應 無 與 要 較 未 等 一 比 田 價 線 居 碼 攤 沾 值 熱 系 
撞=見 擊 斷 著 車 鐘 倒 到 毀 傷 死 上 礁 入 球 破 人 壞 騙  鎖 針 錘 翻 進 碎 
湛=江 藍 賁 清 深 
啾=唧 
赦=免 罪 
淳=樸 厚 美 于 安 化 良 
欠=缺 債 佳 款 扁 資 薪 下 了 妥 產 租 稅 繳 安 火 情 身 伸 條 息 賬 費 錢 載 
歉=意 疚 年 然 收 歲 仄 
茁=壯 實 
杠=子 桿 鈴 夫 頭 房 
毽=子 球 
褥=子 單 墊 套 瘡 
壇=子 主 規 友 
令=尊 郎 愛 堂 箭 慈 旗 人 我 你 其 弟 狀 女 狐 名 親 聞 兄 牌 媛 
峭=壁 立 拔 直 
鵪=鶉 
曙=光 色 
駁=回 斥 倒 船 雜 運 論 岸 難 價 議 
螢=火 石 幕 
丹=麥 方 田 砂 桂 青 藥 紅 楓 陽 心 佛 霞 鳳 參 墀 東 毒 頓 江 徒 巴 
柴=火 米 門 草 禾 扉 胡 油 雞 把 炭 刀 垛 堆 屋 薪 
闡=明 釋 述 揚 發 說 
澡=堂 盆 塘 
楓=葉 樹 木 香 楊 林 
契=約 機 據 合 丹 稅 文 友 
鏈=子 條 結 接 輪 軌 球 表 環 式 鎖 烴 
煎=熬 餅 包 蛋 茶 劑 藥 魚 鍋 炸 煮 
鵝=黃 毛 絨 群 蛋 掌 肉 
診=斷 所 治 室 療 費 病 察 脈 視 聽 
倭=瓜 寇 
殉=國 難 葬 職 道 節 情 教 
霓=裳 虹 
償=還 命 付 債 清 
棱=角 鏡 坎 臺 柱 錐 子 
蚌=殼 埠 類 珠 
僧=侶 人 肇 道 尼 徒 俗 兒 院 眾 帽 袍 衣 
曖=昧 
蚱=蜢 蟬 
啪=達 啦 嚓 嗒 唧 
怦=然 
郊=區 游 野 外 縣 
繚=繞 亂 
蝦=仁 米 子 醬 蛄 類 皮 涌 
唇=舌 膏 吻 齒 緣 邊 裂 筆 讀 線 音 瓣 形 
井=水 臺 口 號 繩 壁 噴 架 鹽 下 筒 田 底 然 蛙 陘 沿 蓋 場 隊 位 
療=養 法 效 程 傷 饑 治 
嘖=
桿=子 秤 菌 兒 塔 狀 
肘=子 部 擊 窩 腋 
獄=卒 吏 中 警 醫 
糕=餅 點 干 
臀=部 圍 尖 鰭 疣 
嗅=覺 到 出 聞 
淋=浴 巴 病 漓 濕 洗 雨 菌 濾 透 
酸=辛 棗 味 菜 軟 疼 鹽 臭 性 梅 的 痛 堿 甜 腐 苦 雨 辣 根 值 奶 懶 敗 鼻 楚 度 化 酐 ? 姜 麻 澀 心 洗 類 乳 
閉=幕 塞 會 了 門 上 關 著 目 口 嘴 起 路 合 館 卷 經 氣 市 鎖 眼 環 架 
瑪=瑙 麗 雅 鋼 多 沁 曲 
夠=嗆 本 小 低 的 了 用 膽 大 多 快 好 高 不 長 狠 格 絕 勁 受 數 味 準 到 慢 
啜=泣 飲 茗 
剽=竊 悍 掠 取 襲 
巍=然 峨 乎 
賢=人 明 惠 德 良 達 淑 妻 哲 士 能 者 弟 勞 路 才 臣 契 侯 
劣=紳 跡 等 貨 質 種 馬 勢 弧 品 幣 地 酒 于 
熏=陶 染 天 風 黑 雞 沐 魚 制 蒸 肉 香 
添=置 加 補 設 入 上 丁 亂 購 彩 堵 色 箱 附 
灼=見 傷 熱 烤 痛 焦 
冊=子 頁 封 立 葉 亨 
勺=子 
丸=子 藥 劑 
縫=補 隙 紉 制 成 合 上 線 綴 子 好 口 里 針 住 摺 
鑄=成 造 鐵 錠 件 幣 錯 焊 工 鋼 模 型 字 出 就 石 銅 物 
汩=
闖=禍 入 蕩 將 下 勁 進 出 關 過 練 王 
惹=禍 事 出 毛 火 來 人 起 得 怒 惱 氣 眼 你 
抨=擊 
痢=疾 
縝=密 
砰=然 
嬉=笑 皮 春 鬧 戲 水 耍 
廝=殺 打 守 混 
刷=洗 子 白 新  屏 地 怪 牙 卡 拉 掉 去 
汲=水 取 引 
魁=梧 首 星 岸 偉 元 
絮=語 叨 狀 煩 聒 棉 說 窩 凝 球 
豢=養 
扉=頁 
孕=育 婦 期 畜 檢 穗 吐 
痊=愈 
莽=撞 漢 蒼 草 原 林 
簪=子 花 纓 
罩=子 衫 袍 著 在 棚 衣 袖 住 上 
禪=宗 師 房 機 定 學 院 理 林 讓 門 堂 悟 杖 
碉=堡 樓 
蛆=蟲 
搞=好 垮 過 懂 上 完 到 笑 掂 得 錯 了 活 鬼 出 成 個 怪 亂 定 清 起 死 臭 大 渾 法 頭 丟 壞 混 來 去 些 砸 臟 糟 
札=記 幌 子 
絢=爛 麗 
瑯=嬛 
駿=馬 
撥=弄 動 款 付 通 出 號 給 冗 開 了 拉 兒 打 發 叫 一 轉 子 快 去 水 土 弦 用 
琥=珀 
癟=三 谷 陷 
颼=
邋=遢 
硯=臺 池 滴 石 田 
串=通 珠 鈴 聯 燒 成 口 案 換 戶 供 崗 講 門 皮 氣 親 味 行 戲 線 鄉 煙 演 游 種 子 接 列 起 音 
蒲=團 扇 草 柳 絨 棒 包 墩 節 劇 劍 葵 桃 城 田 席 圻 
娓=
郎=中 舅 君 貓 平 溪 
繃=帶 子 得 臉 緊 亮 脆 瓷 斷 簧 勁 硬 直 著 
篤=信 定 愛 誠 厚 實 守 學 志 
朵=兒 花 頤 
倏=忽 地 然 爾 
岑=寂 參 
件=事 數 次 
癥=結 候 狀 
鍍=金 鋅 鎳 銀 鉻 膜 銅 錫 
止=境 步 痛 血 癢 于 息 住 咳 水 渴 瀉 
聳=立 肩 肩 動 峙 聽 
勒=令 索 逼 緊 派 死 抑 詐 馬 住 
楠=木 竹 
猙=獰 
甥=女 
猝=然 死 爾 發 
濕=潤 氣 度 地 了 透 疹 軟 熱 布 冷 租 法 婆 疣 
礦=山 工 產 物 務 藏 業 坑 區 井 石 床 砂 局 泉 場 房 體 柱 脈 泥 脂 層 難 車 燈 點 警 苗 棉 田 源 冶 院 長 渣 質 塵 鹽 油 
訕=臉 笑 
桑=樹 梓 葉 拿 蠶 林 果 田 園 榆 麻 苗 植 
箭=頭 步 豬 靶 樓 桿 鏃 竹 程 袋 毒 號 矢 
氛=圍 
拷=問 打 綢 到 貝 紗 入 
=心 產 星 溫 生 久 河 量 定 力 等 濕 山 牙 言 口 
咻=
篆=字 刻 書 文 體 
蛻=變 化 皮 殼 
尿=布 樣 濕 檢 道 酸 液 片 閉 炕 素 路 床 墊 肥 褲 血 血 泡 的 壺 頻 糖 
豁=達 朗 口 子 免 亮 然 出 牙 嘴 開 
剃=刀 度 發 頭 須 
煥=發 然 
芒=果 種 草 刺 硝 康 
旦=角 暮 夕 
銜=接 恨 枚 命 鐵 冤 
川=劇 菜 資 軍 貝 費 江 芎 北 藏 沙 鹽 
貍=貓 子 藻 
枇=杷 
霧=氣 化 狀 靄 滴 ? 峰 社 
秦=腔 嶺 漢 國 朝 檜 瓊 俑 池 人 
扎=實 手 根 在 營 堆 花 緊 啤 煞 眼 針 掙 幌 牢 
授=受 課 予 意 權 銜 粉 獎 勛 時 以 徒 旗 給 精 命 首 業 藝 之 牌 乳 職 
酬=謝 勞 金 和 賓 唱 答 對 應 
仗=義 著 膽 劍 勢 恃 持 
揩=油 拭 布 干 凈 
鱷=魚 
錘=子 煉 打 頭 擊 
墩=子 布 
疹=子 
檔=案 次 期 位 子 主 
屯=兵 墾 糧 集 田 門 落 守 子 扎 留 溪 
蝗=蟲 災 害 
躊=躇 
倦=怠 意 態 容 乏 色 
隧=道 洞 
兜=兒 攬 風 售 肚 銷 子 捕 抄 底 翻 鍪 圈 嘴 里 帽 
諧=和 音 聲 美 波 調 劇 趣 謔 戲 振 語 
炭=火 盆 畫 坑 疽 素 筆 化 墼 精 窯 刷 
兢=
墜=落 子 地 毀 下 入 機 樓 琴 海 
逢=迎 春 集 
番=茄 號 瓜 薯 邦 菜 禺 
孿=生 
扒=手 竊 拉 車 皮 車 灰 糕 雞 開 土 
紋=理 路 波 銀 身 飾 縷 面 樣 
肆=意 虐 擾 力 佰 千 仟 拾 萬 行 億 
兌=現 換 領 付 獎 款 取 
肄=業 
愜=意 當 
謎=語 底 團 題 兒 面 子 
厄=運 難 境 
篩=子 選 糠 分 管 洗 板 骨 孔 析 眼 
摟=抱 在 著 頭 入 住 
肋=骨 條 膜 
斤=兩 斗 
凋=零 謝 敝 落 敗 殘 枯 萎 
糯=米 稻 
諢=名 號 
耍=弄 猴 我 賴 呢 鬧 人 橫 滑 奸 潑 錢 笑 子 
腥=氣 臭 味 臊 膻 
棘=手 輪 刺 爪 
堯=舜 
砸=碎 爛 錢 破 掉 到 磚 死 了 毀 缸 鍋 傷 壞 開 
粘=貼 著 滯 液 性 滿 結 附 稠 連 劑 固 牢 合 膜 住 的 膠 緊 上 在 
匪=徒 禍 軍 幫 盜 首 兵 穴 類 巢 患 窟 
劍=俠 圣 豪 術 眉 客 麻 橋 心 法 道 鋒 士 鞘 柄 峰 閣 河 尖 蘭 形 魚 宗 
彗=星 尾 
戊=辰 戌 醇 基 醛 炔 酸 酮 烷 烯 寅 
奄=然 
羔=羊 子 皮 兒 
飼=養 料 草 喂 育 
撐=腰 地 大 到 起 著 臂 住 持 船 桿 篙 開 破 死 傘 竿 了 
漣=漪 波 水 源 
播=音 種 放 送 灑 出 映 下 講 弄 報 發 火 撒 散 揚 遷 
煞=白 住 尾 費 氣 是 筆 裉 
湯=圓 面 藥 匙 鍋 壺 水 姆 加 料 包 池 罐 劑 泉 勺 色 頭 團 碗 沛 尼 陰 原 
囂=張 雜 浮 
擱=置 淺 筆 放 起 下 板 延 
袋=子 鼠 中 裝 里 內 熊 
鉤=子 蟲 沉 秤 緩 玄 針 爪 鼻 邊 棍 住 狀 
聾=子 了 人 啞 
堤=岸 壩 防 堰 埂 坡 圍 垸 道 
勃=起 發 然 朗 
韭=菜 黃 芽 蔥 
紡=綢 織 車 紗 線 錘 機 錠 絲 
叨=念 擾 登 咕 
嗎=啡 
梗=概 塞 阻 死 節 
隴=海 南 劇 川 西 縣 
癱=瘓 軟 子 倒 坐 
煌=
淫=穢 蕩 威 亂 笑 聲 猥 褻 婦 雨 賤 樂 詞 畫 棍 書 邪 欲 媒 靡 巧 
檳=榔 
湮=沒 滅 
殲=滅 敵 匪 擊 
鑲=嵌 著 邊 金 牙 板 入 
侏=儒 
卵=石 白 巢 子 塊 黃 泡 生 形 翼 管 殼 裂 膜 
拂=拭 曉 過 塵 逆 動 面 袖 煦 意 掉 去 
垮=臺 了 掉 塌 
曬=臺 衣 黑 種 干 場 簟 圖 煙 鹽 過 
梢=頭 門 
吮=吸 咂 
棲=息 身 蟾 居 止 木 霞 
悻=然 然 
栩=
妃=子 嬪 色 
腕=子 力 套 表 兒 骨 級 足 尺 
蝎=子 虎 
鷂=子 鷹 
寨=子 主 
駝=背 絨 峰 子 鈴 鹿 色 群 
拓=本 片 荒 寬 展 跋 邊 地 撲 印 殖 
染=坊 指 色 綠 料 病 缸 上 發 污 成 紅 布 毒 疾 織 房 液 整 
霏=微 
猩=紅 草 
弓=箭 著 手 雖 子 形 弩 步 背 身 弦 腰 鋸 起 
豺=狼 狗 
縷=述 析 
笸=籮 籃 
綱=目 要 領 常 紀 
仕=女 途 宦 進 
乒=乓 聯 賽 壇 協 
膠=皮 東 州 水 卷 丸 管 片 布 合 鞋 印 版 泥 體 袋 紙 囊 帶 著 料 原 質 輪 鬲 結 木 靴 板 化 粒 膜 南 粘 住 狀 
嘁=
嫣=然 紅 
袈=裟 
塞=外 子 給 得 到 車 進 入 滿 住 北 尺 規 上 責 族 飽 緊 
熙=攘 和 
茴=香 
翱=翔 
諾=言 曼 爾 頓 思 亞 
瘟=疫 神 病 疹 
饋=贈 送 線 電 
繭=子 綢 絲 
淙=
奠=定 基 酒 儀 
蒸=發 氣 籠 汽 鍋 餾 餃 食 熟 魚 餅 飯 烤 饃 騰 煮 肉 
匍=匐 
桅=桿 檣 燈 頂 杠 樓 
煉=鋼 鐵 制 油 焦 獄 成 乳 丹 話 句 山 字 功 藥 
赫=本 然 哲 爾 連 茲 斯 章 
肝=火 膽 炎 氣 胃 兒 癌 臟 部 病 功 腸 糖 素 蛭 
菱=角 形 
倚=靠 仗 天 重 音 
陀=螺 
茸=毛 
韁=繩 
磐=石 安 
梨=樹 子 園 膏 渦 花 狗 果 酒 山 
貌=似 美 相 
訃=聞 告 文 
贓=物 官 證 款 品 
揪=心 住 出 斗 痧 扯 打 
弧=形 線 面 度 菌 光 
螺=旋 螄 絲 紋 釘 鈿 號 桿 距 母 帽 栓 攻 線 
吊=唁 車 射 燈 桶 帶 橋 銷 鉤 架 扣 起 在 掛 蘭 樓 床 窗 打 頂 環 祭 毛 鋪 球 扇 死 繩 喪 索 塔 梯 線 孝 裝 膀 放 桿 籃 門 嗓 針 著 
喂=養 奶 食 料 飯 草 馬 
蓄=意 水 謀 積 勢 念 能 洪 發 須 養 志 財 電 熱 
誓=愿 師 言 死 與 詞 不 約 由 
卓=越 然 識 著 絕 立 異 有 資 
笤=帚 
諄=囑 
筏=子 運 
殼=子 兒 牌 質 
伏=案 天 流 筆 魔 兵 法 貼 擊 特 在 羲 虎 地 安 暑 帖 線 汛 誅 
羈=絆 留 押 勒 旅 泊 縻 
胎=兒 生 發 教 毛 盤 黃 動 毒 記 膜 氣 位 衣 胞 痣 
襄=樊 陽 助 理 禮 城 汾 垣 
颶=風 
凈=化 土 白 角 余 值 額 利 的 身 重 水 增 盡 賺 菜 價 口 空 手 是 桶 高 心 
騰=空 地 飛 躍 出 龍 訊 挪 讓 達 房 貴 越 涌 沖 起 
耷=拉 
逆=流 子 產 轉 境 風 水 勢 差 向 料 耳 旅 反 光 價 行 序 火 數 著 
蓓=蕾 
泯=滅 沒 
攫=取 奪 去 
悍=然 馬 將 匪 婦 勇 
冉=
唉=呀 聲 嘆 
蛛=網 絲 
捍=衛 御 拒 
撂=下 倒 地 荒 跤 手 
惰=性 
盟=國 誓 主 友 邦 軍 員 約 書 
蓑=衣 草 
載=重 客 運 貨 體 有 明 著 滿 文 人 譽 舟 波 荷 頻 記 入 
爬=蟲 行 高  上 山 出 升 犁 過 動 灰 竿 滿 坡 樹 梯 去 下 泳 
溢=出 彩 滿 美 流 血 值 
擊=打 中 敗 破 退 落 斃 劍 潰 垮 沉 毀 球 倒 傷 鼓 穿 碎 節 鍵 發 水 掌 到 昏 
嗝=兒 
迸=發 裂 濺 射 出 流 
撮=合 要 弄 箕 
爾=后 雅 曹 等 格 
庇=護 蔭 佑 
臟=話 字 腑 亂 土 器 的 病 水 污 活 了 
削=減 弱 發 平 面 價 球 職 薄 除 掉 刮 尖 皮 去 
罰=款 金 下 息 則 球 錢 單 酒 沒 站 出 分 中 
蟑=螂 
葬=禮 身 送 地 埋 月 儀 
崛=起 
竊=取 賊 聽 案 盜 奪 國 據 密 笑 喜 
嚼=舌 爛 蠟 用 子 碎 
董=事 潔 平 璇 勇 卓 
埠=頭 
糞=土 便 坑 池 肥 桶 堆 ? 車 
遐=想 邇 齡 思 
嘶=啞 叫 喊 鳴 聲 
泱=
怏=然 
熬=夜 煎 心 藥 過 磨 頭 湯 油 粥 成 到 
錄=音 取 用 像 下 在 制 入 到 放 供 影 播 事 
遨=游 
鱔=魚 
捆=扎 綁 兒 縛 子 住 
棄=置 將 權 用 絕 之 嬰 兒 婦 官 耕 學 養 船 世 子 
秒=鐘 了 針 表 
蹄=子 聲 筋 膀 墊 鐵 印 
胰=子 腺 液 臟 島 
梔=子 
崖=壁 刻 谷 略 
薈=萃 集 
艦=隊 船 載 艇 炮 橋 體 長 只 首 
岌=
酗=酒 
銘=刻 文 記 感 旌 牌 心 謝 
顆=粒 
妝=奩 飾 扮 點 新 樓 臺 
褡=褳 
麒=麟 
骷=髏 
齒=輪 形 冷 錄 及 鯨 數 根 舌 條 音 狀 
孑=然 立 孓 
磋=商 磨 
霎=時 那 
覓=食 到 得 取 求 
詔=書 令 
鷺=鷥 
液=體 汁 晶 壓 化 態 氨 氮 果 泡 狀 冷 流 囊 
灶=君 神 火 間 房 具 膛 頭 臺 屋 
仲=夏 尼 裁 秋 春 冬 家 山 巴 
馨=香 
蛇=蝎 身 類 足 口 頭 年 麻 皮 膽 毒 豆 蛻 行 形 醫 性 座 
雛=形 兒 鳥 鷹 型 菊 妓 雞 燕 鴨 鴿 
霜=葉 凍 天 花 期 雪 晨 害 降 鬢 
駭=異 怪 客 人 然 懼 浪 
遏=止 制 抑 阻 
竿=子 
呢=子 絨 喃 料 
瘡=疤 口 痂 痍 
蹦=迪 床 高 極 跳 出 達 
戳=穿 透 記 兒 破 子 
敦=促 厚 勸 請 實 煌 睦 聘 化 
函=電 授 件 購 大 數 調 復 告 索 售 
鼎=立 力 盛 沸 革 新 足 助 銘 
譜=兒 子 號 系 表 寫 牒 曲 
棧=房 道 橋 戀 
趾=頭 骨 甲 部 
塘=沽 鵝 泥 壩 庫 堰 魚 
擂=鼓 臺 主 
吻=合 你 別 獸 她 
昭=和 示 雪 著 明 然 告 彰 覺 君 蘇 通 
猿=猴 人 聲 
弛=緩 懈 禁 
囤=積 糧 聚 
腮=頰 邊 腺 紅 須 
盔=甲 頭 子 
又=嫌 兼 有 是 一 要 會 說 可 在 不 能 稱 如 被 將 為 想 與 名 因 把 叫 問 怕 見 用 從 得 去 很 來 使 像 累 給 出 高 熱 同 成 及 求 訊 慢 
拮=據 抗 
籮=筐 
佇=立 足 候 聽 
株=連 距 守 型 洲 選 
丘=陵 墓 腦 八 垤 壑 疹 縣 
輯=錄 要 佚 
筑=路 牢 起 成 巢 堤 城 壩 波 
蕎=麥 面 
帷=幔 子 幕 幄 帳 
翎=毛 子 
剿=滅 殺 除 匪 說 共 絲 
杉=木 樹 
啄=死 食 痕 
瞠=目 
陵=墓 園 廟 寢 替 水 縣 
礁=石 堡 
匕=首 
砒=霜 
胚=胎 囊 軸 乳 層 芽 珠 根 盤 
姘=頭 居 婦 夫 
汕=頭 大 尾 
灘=頭 地 簧 涂 羊 
旨=意 在 趣 
恣=意 情 肆 睢 
鯨=魚 吞 鯊 須 油 
賑=災 濟 恤 
坯=子 布 料 胎 
崽=子 
幛=子 
襁=褓 
錫=箔 紙 礦 杖 金 蘭 伯 匠 劇 林 器 山 石 
蠻=橫 干 夷 力 快 有 大 纏 荒 好 勁 子 多 人 行 勇 早 
寸=心 土 楷 陰 金 步 長 草 斷 功 進 頭 鐵 
舟=車 橋 山 楫 骨 子 
揉=搓 合 磨 面 成 捻 捏 碎 
渠=道 灌 溝 
拔=掉 除 尖 腿 草 高 河 錨 出 絲 起 刀 去 劍 槍 地 份 腳 取 群 俗 營 擢 根 開 了 毛 染 下 牙 
藕=粉 色 荷 灰 
匹=夫 敵 馬 配 
鷓=鴣 
蟈=兒 
迂=回 緩 腐 闊 曲 論 執 拙 儒 路 
踽=
侃=兒 爺 
瀏=覽 陽 
琳=瑯 
毗=連 鄰 
蔭=涼 庇 蔽 棚 翳 
聊=天 著 起 得 到 天 齋 賴 城 且 生 一 以 
媲=美 
賤=民 人 賣 買 價 內 貨 種 物 妾 
楷=模 書 體 式 
喬=木 遷 治 裝 丹 石 榛 峰 
淤=泥 積 塞 血 灌 沙 滯 
翌=日 年 晨 
渙=散 然 
舵=手 輪 主 工 盤 柄 機 
隸=書 屬 字 體 卒 農 
嫻=熟 靜 雅 淑 
劫=數 掠 難 持 機 案 匪 后 奪 道 犯 獄 盜 色 
鹽=水 酸 花 城 類 場 池 分 湖 霜 田 業 法 鹵 山 析 井 粒 巴 工 堿 礦 民 泉 商 稅 灘 土 梟 漬 沼 邊 的 度 瓶 亭 汁 
遞=送 交 減 增 給 上 延 解 變 補 歸 進 降 加 升 呈 回 價 推 
炕=頭 桌 床 席 幾 洞 梢 沿 
芋=頭 艿 
兆=頭 位 周 赫 歐 瓦 喝 
剖=析 白 解 開 腹 面 視 釋 
盥=洗 漱 
韌=性 帶 皮 勁 度 
娟=秀 
裨=益 將 
丙=寅 級 炔 綸 烯 部 丁 肝 酮 烷 辰 醇 方 基 醛 申 酸 午 子 
瀕=于 臨 危 死 海 絕 
吳=語 江 國 興 京 軍 鉤 越 中 坎 川 剛 橋 忠 淞 
赴=約 美 會 京 英 任 難 敵 宴 義 
錚=亮 
驗=證 方 收 血 尸 身 貨 尿 核 光 關 看 明 票 訖 算 墑 資 質 印 
膾=鯉 
幢=
靶=子 場 標 船 點 臺 心 向 
臣=子 僚 仆 服 民 下 妾 
鉗=子 制 工 床 擊 口 
榛=子 
?=粑 
蝕=本 刻 
戈=壁 爾 矛 
葷=菜 腥 油 話 口 
榴=彈 蓮 火 
芥=蒂 菜 末 菜 黃 
甩=掉 手 賣 開 餅 車 動 腔 脫 站 出 干 頭 
湘=繡 江 軍 簾 竹 西 蓮 菜 贛 劇 潭 語 云 南 鄉 陰 
釣=竿 鉤 餌 魚 到 具 磯 絲 線 譽 
疤=痕 瘌 
涓=滴 埃 子 
貸=款 方 出 放 
量=力 度 詞 杯 變 刑 的 在 有 增 化 表 產 能 身 地 子 出 販 程 規 綱 具 級 塊 瓶 器 算 筒 計 
伉=儷 
棟=梁 樓 宇 
狩=獵 
粼=
犬=馬 子 牙 吠 儒 齒 
罵=名 我 人 你 得 街 過 娘 架 陣 聲 
毋=寧 庸 須 
盾=牌 構 板 
貂=皮 蟬 熊 
儉=樸 省 約 
匠=人 心 氣 
己=任 巳 見 方 身 醛 炔 酸 酮 烷 烯 
犒=賞 勞 師 
吭=聲 氣 哧 
罅=隙 漏 
跡=象 線 
輟=學 筆 
涮=人 肉 鍋 洗 
勛=章 業 績 爵 勞 
瀘=州 
痱=子 
瘸=子 腿 的 
楔=子 入 形 住 
備=案 課 荒 用 胎 了 戰 查 齊 注 有 受 忘 份 好 耕 料 考 足 至 下 辦 貨 件 品 勤 取 述 選 汛 置 災 感 
虹=彩 橋 口 膜 吸 鱒 
蛔=蟲 
哮=喘 
皆=備 有 無 因 可 以 能 宜 知 是 
鋌=
骸=骨 
括=號 弧 
詆=毀 
嘰=咕 
驍=將 勇 悍 騎 
掘=開 進 出 井 土 地 坑 墓 起 
碗=口 櫥 里 底 柜 筷 腔 
伊=朗 妹 利 始 人 甸 春 犁 蘇 籍 川 敏 寧 索 通 
琺=瑯 
瓊=樓 斯 瑤 山 海 華 漿 劇 脂 花 結 中 
轅=門 馬 騾 子 
蒜=苗 頭 泥 農 粒 瓣 黃 毫 
逞=能 強 兇 性 威 
旌=旗 表 
燥=熱 裂 
旭=日 
硝=石 煙 酸 鹽 化 基 
憾=事 
遣=送 散 返 詞 興 
纜=索 繩 車 柱 
媚=態 骨 眼 日 氣 俗 世 外 笑 悅 惑 娘 人 顏 
聆=聽 教 取 
裹=腿 在 挾 進 亂 腳 脅 扎 足 布 住 
滂=沱 湃 
彪=炳 悍 發 赫 虎 口 軀 文 耀 壯 章 
悟=性 空 出 道 徹 
雌=雄 性 蕊 鵝 鹿 鴨 化 伏 黃 豹 的 虎 花 驢 馬 鳥 禽 獅 獸 蟻 
斡=旋 
懨=
讕=言 
螻=蟻 ? 蛄 
鯊=魚 
佐=證 料 餐 理 酒 
叉=子 著 腰 燒 車 齒 開 路 形 
褶=子 皺 
傣=族 劇 
涔=
鋸=齒 子 末 床 條 掉 斷 開 屑 
邯=鄲 
械=斗 
咄=嗟 
戴=上 爾 著 帽 花 軍 孝 
御=寒 史 姐 醫 用 苑 覽 筆 賜 敵 駕 批 前 侮 者 座 
惱=恨 了 怒 人 火 
葵=花 扇 
曇=花 翼 域 
篝=火 
瞬=間 刻 即 時 息 態 
磊=落 
隕=落 石 滅 鐵 星 
捎=帶 話 腳 來 信 
饃=
鴕=鳥 
鷙=鳥 
樞=紐 機 要 軸 
荸=薺 
沁=入 涼 潤 水 陽 源 
哺=乳 育 養 
噪=聲 音 
萍=聚 鄉 蹤 
貶=損 值 低 褒 詞 職 抑 價 義 稱 斥 黜 毀 官 責 謫 
殿=堂 下 軍 宇 內 后 試 
葦=塘 子 席 叢 箔 蕩 
忐=忑 
疆=土 域 場 界 埸 
兮=
悉=心 尼 數 力 
巢=穴 窟 湖 居 
辟=謠 邪 谷 易 邪 
際=遇 會 涯 
軒=轅 敞 昂 朗 輊 
孜=然 
挾=持 帶 裹 嫌 制 
懈=怠 氣 
膳=費 食 宿 
輩=分 數 出 行 子 
鴻=溝 儒 蒙 雁 毛 運 鵠 基 烈 文 爪 恩 漸 篇 業 源 
峽=谷 江 口 灣 
襟=懷 抱 翼 
硫=磺 酸 化 分 黃 
締=結 造 約 交 盟 
癲=狂 癇 子 
潰=爛 敗 決 散 退 瘍 逃 亂 膿 兵 堤 軍 口 滅 圍 裂 
伎=倆 
楹=聯 
轆=轤 
茹=
峨=嵋 眉 
繳=納 獲 回 槍 付 交 費 稅 款 清 械 銷 租 庫 
樟=腦 樹 木 
嗯=
脅=迫 從 持 制 
輻=射 條 輳 照 
磁=石 力 場 浮 盤 性 碟 帶 鐵 矩 療 磚 卡 心 選 頭 化 能 暴 棒 道 鼓 鋼 極 控 漆 體 條 學 芯 針 電 粉 軌 畫 路 片 勢 縣 軸 阻 
唆=使 
躡=足 蹤 
緝=私 捕 拿 毒 兇 查 獲 
摹=寫 本 刻 印 繪 效 狀 
秉=性 承 公 持 直 筆 賦 國 鈞 燭 政 正 著 
弘=揚 法 治 大 道 遠 
贍=養 
殯=車 葬 儀 殮 
咎=
魷=魚 
俚=語 歌 曲 俗 
蕪=雜 菁 湖 劣 鄙 穢 
癌=癥 病 變 魔 痛 腫 學 
匙=子 
缸=子 盆 瓦 管 蓋 磚 體 
砂=子 石 礫 粒 土 糖 眼 紙 鍋 樣 輪 囊 布 漿 礓 礦 皮 型 巖 仁 質 
錐=子 心 形 體 度 面 栗 
樁=子 基 木 
瑤=族 池 臺 鄉 
則=是 為 可 會 在 有 由 以 要 應 說 被 較 需 將 無 用 已 其 從 因 按 能 稱 又 使 天 聲 通 取 
臆=測 造 斷 說 度 見 想 
楚=天 漢 歌 國 辭 王 劇 人 雄 
搓=洗 板 成 麻 弄 揉 腳 澡 手 
嗒=
鍥=
庫=房 藏 存 內 容 侖 倫 藏 緞 錦 券 區 車 恩 克 
閹=割 了 人 雞 牛 黨 宦 豬 
磷=光 火 肥 礦 酸 蝦 脂 
洱=海 
卸=貨 任 妝 下 責 鞍 載 車 船 肩 運 裝 職 除 掉 荷 去 
倍=加 增 兒 受 數 感 速 添 覺 率 道 頻 式 
鐫=刻 鏤 
紈=? 
鶴=鳴 壁 山 發 崗 慶 
峻=嶺 峭 拔 急 險 
滯=留 后 銷 納 泥 洪 緩 港 澀 壓 脹 塞 
峰=巒 高 會 值 頂 年 巔 位 度 尖 丘 
韜=略 晦 光 
稠=密 度 糊 
阡=陌 
訥=河 
癩=瓜 子 
詐=騙 敗 取 降 語 欺 唬 尸 死 稱 術 
嫡=親 派 系 傳 出 母 堂 
卿=
鷹=犬 洋 派 隼 潭 爪 架 眼 
昌=盛 平 隆 黎 
肇=事 禍 慶 始 基 亂 端 東 源 
息=怒 影 肉 兵 肩 訟 止 錢 事 
稅=收 務 卡 捐 率 款 票 源 則 制 前 后 種 額 金 法 費 單 利 負 關 目 賦 付 契 
蜷=縮 伏 曲 
暈=倒 眩 了 車 死 菜 船 場 池 厥 機 針 圈 
睪=丸 
訊=問 息 號 景 實 
鄧=肯 選 超 
慧=心 眼 黠 明 根 蘭 星 
瀉=藥 肚 出 
嚶=
諍=友 諫 言 
吁=請 
閏=月 年 日 秒 
蕓=香 
抉=擇 摘 
鑿=子 空 孔 枘 開 沉 成 穿 洞 井 巖 
稟=報 性 帖 賦 告 明 命 受 奏 
魏=碑 國 徵 征 
級=別 差 數 會 次 長 聯 任 
彬=縣 
貯=藏 存 量 備 運 槽 
勘=察 測 探 查 定 校 界 誤 驗 正 
剎=車 那 住 那 閘 
磅=秤 ? 
遁=詞 形 跡 世 走 
彭=丹 山 縣 澤 
幅=度 員 面 寬 
篡=奪 位 改 黨 國 權 
嗣=后 位 子 
熔=化 巖 爐 鑄 池 融 煉 點 斷 合 解 劑 冶 度 焊 接 
蟹=黃 殼 肉 粉 苗 青 
絞=架 索 刑 盤 痛 臉 車 纏 結 殺 死 出 盡 鏈 起 首 
佼=者 
恤=金 衫 
鐐=銬 
拗=口 勁 勁 
濁=流 水 音 浪 度 世 
蛟=龍 
馱=馬 轎 運 
鬃=毛 刷 
擯=棄 除 斥 
瀝=青 澇 水 
歹=人 意 徒 念 話 毒 心 
酥=軟 糖 胸 脆 麻 油 松 餅 
愧=色 疚 領 赧 恨 悔 汗 見 痛 怍 對 
遜=色 于 位 
陋=室 習 規 俗 屋 巷 
葛=藤 洪 布 畈 麻 優 
偕=同 老 行 
貽=誤 害 
遂=心 行 意 愿 寧 昌 川 道 平 
贅=婿 疣 述 言 肉 詞 瘤 
奕=
醋=意 酸 栗 大 勁 精 心 化 
覬=覦 
溯=源 流 
沼=澤 氣 池 地 
諭=旨 示 
箋=紙 注 札 言 
睿=智 
垛=子 堞 口 
鑷=子 
梭=子 鏢 巡 魚 羅 曼 
粑=
皂=白 莢 石 化 角 片 素 隸 ? 
舢=板 
挎=包 斗 著 
戍=邊 守 
泣=血 訴 
蛀=蟲 牙 蝕 洞 食 
蟾=蜍 宮 光 酥 
訛=傳 詐 誤 謬 人 舛 奪 錢 脫 字 
痔=瘡 漏 
酩=酊 
熨=斗 平 帖 燙 
嘎=登 巴 調 吱 子 聲 響 
韓=國 磊 文 愈 語 劇 日 流 紅 非 維 雪 城 青 元 
橙=色 子 汁 紅 皮 黃 木 
憨=厚 態 直 癡 氣 實 傻 笑 子 
絹=花 本 畫 絲 子 綢 紡 扇 素 
墾=荒 覆 區 殖 種 利 
鱗=甲 片 爪 莖 波 介 傷 屑 狀 
賜=教 稿 給 福 予 死 
秫=秸 米 
薦=舉 引 
?=嚓 嚓 嗒 噠 嘰 唑 
螳=螂 
綺=麗 靡 羅 年 
閘=門 口 瓦 刀 盒 閥 皮 板 北 
匿=了 名 跡 藏 報 伏 
朽=木 壞 爛 敗 邁 
刁=難 鉆 滑 頑 悍 惡 橫 蠻 民 
奎=寧 屯 
牯=牛 
嚏=噴 
萋=
杞=
縐=紗 布 
萵=筍 苣 
蟠=桃 龍 
凹=凸 陷 面 度 進 版 鏡 下 槽 處 地 痕 角 坑 洼 形 
譽=為 
偃=
麝=香 鼠 
梟=雄 將 首 
熠=
惻=然 隱 
摯=友 愛 誠 情 
鰻=魚 鱺 
霖=雨 
鏖=戰 兵 
疊=嶂 影 嶺 好 放 出 成 加 印 韻 蓋 起 翠 合 字 接 句 
頤=養 
掣=肘 
敝=人 舊 屣 舍 
稗=子 草 官 史 
椽=子 筆 
痞=子 積 塊 
饞=嘴 鬼 貓 涎 
膿=包 瘡 胸 瘍 腫 水 血 汁 
莧=菜 
羹=匙 湯 
瑕=疵 玷 
踢=打 飛 館 爆 出 得 球 腿 到 開 人 蹬 騰 踏 回 腳 進 起 傷 射 死 脫 
臍=帶 
釜=山 
撼=動 
煮=沸 粥 湯 食 熟 飯 的 成 茶 餃 蛋 
淀=粉 
躬=逢 耕 親 身 行 
鸞=鳳 儔 
秤=桿 錘 鉤 砣 紐 毫 花 盤 星 
艄=公 
巾=幗 
渤=海 
祥=和 瑞 云 盡 子 麟 
湍=急 流 灘 
龜=鑒 裂 甲 頭 縮 板 背 鏡 足 殼 茲 
閩=江 劇 南 菜 侯 北 清 
鈍=角 刀 化 器 響 滯 的 
菌=類 素 核 肥 落 苗 絲 子 種 株 棒 根 膜 體 
牟=利 取 
粒=橙 子 選 狀 肥 度 級 徑 雪 
蟬=聯 鳴 蛻 衣 翼 兒 
冶=煉 金 艷 鑄 容 鐵 游 
賊=亮 眼 贓 窩 船 心 星 人 膽 風 寇 死 性 子 巢 黨 營 
蒞=臨 任 會 
螟=蛉 蟲 害 蛾 
?=轆 
廓=落 清 張 
嬤=
纓=帽 子 絡 
育=苗 才 秧 種 嬰 兒 成 人 雛 肥 齡 林 珠 
斃=命 了 傷 
柚=木 子 
慕=名 容 
般=配 的 若 
氧=氣 化 吧 割 
迥=然 異 若 別 
怡=和 人 情 然 神 悅 
瞳=仁 孔 亮 
甕=城 安 
逸=事 民 興 聞 出 樂 趣 群 豫 度 品 仙 
矍=鑠 
穆=勒 爾 
蔗=糖 農 渣 田 
缽=頭 盂 滿 子 
撓=頭 度 鉤 曲 秧 癢 
檄=文 書 
苔=蘚 原 
椒=鹽 江 
偎=依 坐 傍 抱 貼 倚 
蜥=蜴 
聒=噪 耳 
叱=? 令 呵 喝 干 罵 問 責 
吏=治 部 胥 
戎=裝 機 馬 
鞍=子 馬 鋼 山 韉 轡 
蛾=子 眉 
睚=眥 
氏=族 
皚=
鋅=版 白 板 粉 礦 皮 片 
甄=別 選 錄 審 
乙=丑 醇 醚 部 級 類 烯 型 ? 腦 胺 方 肝 炔 醛 酸 烷 苯 基 
瞅=準 見 著 
坡=地 度 道 田 路 
塔=頂 影 身 高 樓 門 式 爾 林 輪 吊 灰 尖 臺 鐘 崩 城 河 內 外 座 
跺=腳 腳 
餡=兒 餅 
鳴=放 蟬 謝 槍 管 聲 囀 笛 鞭 唱 鏑 鼓 叫 金 炮 禽 響 冤 奏 鳳 鑼 鳥 
竣=工 
鵓=鴣 鴿 
惠=顧 安 存 普 州 及 民 澤 陽 東 臨 風 允 贈 賜 
醇=厚 化 酒 濃 醪 和 美 酸 香 正 的 樸 
犁=鏵 頭 柄 耕 溝 牛 地 田 杖 板 刀 
孵=化 卵 出 蛋 育 
誑=話 騙 語 
皎=潔 然 白 月 
殫=
捻=軍 子 度 接 
鏢=客 師 局 
囊=括 腫 揣 蟲 胚 生 瘤 中 
紕=漏 繆 
擄=掠 走 奪 
犖=
俺=們 暈 村 家 
皖=南 北 
呶=
麗=雅 日 江 音 娜 人 臺 水 質 都 
捱=
廖=
罹=難 患 病 禍 
鄒=虹 平 衍 城 
揍=打 人 你 
纂=輯 修 
巔=峰 
徇=私 情 
狎=客 昵 妓 
猥=褻 劣 陋 辭 瑣 
赧=然 顏 
梁=效 山 靜 天 祝 子 柱 河 家 平 丘 園 
戚=芳 跡 
?=肥 
靚=照 女 仔 車 妹 湯 麗 號 妝 妞 
暨=南 大 今 
糗=事 
蚩=尤 
祛=魅 病 斑 暑 除 痰 疑 瘀 
?=綸 
晏=子 駕 殊 
瑙=魯 
繆=斯 
緋=色 聞 紅 
濮=陽 
溧=陽 水 
涿=州 縣 
浣=熊 紗 衣 
怵=目 惕 
嵩=縣 山 
崆=峒 
嶗=山 
嵐=皋 煙 
噤=聲 
嗑=藥 破 
咧=開 嘴 
叩=開 門 擊 響 頭 拜 打 閽 關 見 首 問 謝 診 
弒=母 君 
忒=煞 
揠=苗 
薰=風 
蕨=類 菜 
蒹=葭 
鶯=歌 語 
佘=山 
伽=馬 瑪 藍 葉 
綴=滿 合 文 出 輯 字 
幀=數 頻 
睜=著 開 大 眼 
脹=滿 大 紅 庫 痛 閘 起 氣 
賬=務 戶 目 單 號 上 本 簿 冊 房 款 面 
齋=主 戒 月 飯 果 醮 堂 期 日 
乍=現 聽 看 然 得 見 
軋=死 花 鋼 輥 場 機 制 件 平 聲 
擇=時 友 要 業 日 一 偶 優 鄰 菜 交 期 取 食 席 校 選 
豫=章 劇 北 東 西 園 
喻=的 為 義 
易=水 忘 容 手 于 用 受 事 名 學 主 行 經 燃 患 懂 得 讀 地 變 彎 怒 碎 與 人 位 幟 爆 貨 門 
頁=頂 首 面 數 次 碼 尾 腳 眉 心 巖 
勿=要 入 擾 怪 忘 近 翁 笑 動 
吾=愛 人 等 輩 曹 儕 國 生 
燙=著 金 面 傷 蠟 熱 發 花 手 頭 心 嘴 的 過 洗 衣 
碳=素 酸 粉 棒 化 黑 刷 
誰=肯 將 干 叫 說 的 人 的 都 會 說 有 又 家 要 敢 想 呀 信 料 邊 知 道 看 是 問 為 不 能 也 
拴=在 縛 緊 住 
蜀=國 道 錦 葵 山 漢 黍 川 相 中 
薩=特 拉 爾 迦 那 米 姆 斯 伊 
鵲=巢 橋 起 
擎=起 天 
擒=賊 拿 獲 敵 住 
潘=安 婕 
怕=誰 煩 人 是 得 死 羞 事 熱 黑 累 不 苦 生 鬼 冷 癢 
擰=成 緊 動 開 上 松 
孽=緣 情 海 根 種 障 
瞇=著 起 成 縫 瞪 細 眼 
鎂=粉 磚 砂 
顱=內 骨 腔 腦 
晾=衣 干 曬 臺 涼 
撈=到 取 錢 起 本 著 出 
攬=月 下 勝 承 儲 活 貨 工 過 客 權 總 入 
萊=辛 特 切 因 姆 菔 西 頓 蕪 陽 茵 州 
砍=死 樹 到 人 伐 刀 掉 斷 下 你 柴 價 殺 成 倒 光 去 傷 頭 鑿 著 
堪=為 稱 輿 當 比 驚 憂 
灸=法 
藉=口 此 由 以 
鍵=值 盤 入 位 鈕 擊 控 碼 名 
冀=州 望 東 盼 求 圖 中 南 
薊=門 縣 
稽=察 核 查 征 留 考 延 首 拿 
癸=未 醇 醛 炔 酸 酮 烷 烯 
庚=戌 午 子 日 帖 辰 醇 基 醛 炔 酸 烷 烯 寅 
該=打 罵 殺 項 區 處 署 會 校 局 類 批 人 國 地 段 報 片 書 市 案 是 有 黨 院 文 做 說 廠 劇 死 用 店 車 受 去 上 縣 當 島 欠 著 唱 詞 到 來 收 行 
弗=如 萊 蘭 
藩=王 屬 籬 國 屏 鎮 
伐=樹 木 善 區 
剁=成 肉 碎 
蝶=衣 泳 戀 形 子 
叼=著 
氮=素 化 氣 源 肥 
氨=酸 氣 水 
於=
鼠=疫 標 類 輩 竄 膽 害 夾 瘡 穴 藥 蹊 
韶=關 華 光 山 秀 
鋁=制 箔 錠 礦 土 
狄=龍 
俟=機 
誅=戮 滅 殺 
攢=夠 動 盒 集 聚 機 錢 射 
亦=可 有 會 不 應 在 曾 即 無 非 稱 然 舒 
呂=布 
旖=旎 
縛=牢 住 
摁=著 釘 倒 扣 
娜=
蓉=兒 城 樹 
莉=絲 
洛=陽 桑 城 川 
艾=子 蒿 灸 葉 炙 
啦=
您=請 的 們 好 說 老 早 
扳=開 機 手 回 平 了 倒 道 動 子 鉗 頭 著 
掰=開 
扯=皮 上 淡 謊 到 呢 白 臊 腿 遠 出 掉 斷 帆 開 裂 平 破 起 碎 下 
粢=飯 飯 
蹭=飯 蹬 
捶=背 背 打 擊 
盯=著 上 住 緊 防 梢 人 
諜=報 
襠=下 
迪=慶 吧 廳 普 奧 化 
硅=片 石 谷 鐵 膠 鋼 油 肺 化 酸 藻 酮 烷 磚 
撿=到 起 回 拾 漏 柴 來 錢 
?=? 
靖=邊 康 安 江 宇 州 
摳=門 搜 唆 
卯=上 是 眼 榫 
翹=課 楚 首 起 棱 盼 企 望 
啥=事 時 樣 子 
剔=毛 除 紅 透 去 牙 
犀=角 牛 利 鳥 
喲=? 
蟄=伏 蟲 居 
咋=啦 舌 地 辦 的 呼 個 樣 唬 
蹺=板 
嬴=政 
愣=神 是 住 怔 
譚=盾 婆 兵 
誆=騙 
誨=淫 
蟒=蛇 袍 
晉=升 謁 級 劇 代 江 朝 城 見 綏 中 職 國 寧 書 陽 
翔=實 升 
簞=
炙=熱 烤 
殊=榮 異 功 死 勛 譽 
穢=土 聞 行 語 亂 氣 
飾=物 詞 演 品 帶 釘 針 
軸=線 心 子 距 承 瓦 箱 孔 套 襯 封 頸 流 突 系 向 
沆=瀣 
苜=蓿 
逶=迤 
蜉=蝣 
茱=萸 
彤=云 
涸=
漳=州 河 平 浦 
撣=子 帚 
耙=子 犁 地 
筍=子 干 雞 瓜 尖 
嗷=叫 
茭=白 
櫛=比 
芹=菜 獻 
篷=車 布 帆 子 
咫=尺 
寇=仇 坦 準 邊 
躉=船 貨 買 賣 批 售 
?=
蹬=腿 腳 踏 
洼=地 陷 
蹲=點 下 班 膘 伏 坑 苗 守 著 坐 
酌=定 情 量 辦 減 收 
緯=度 書 紗 線 
沫=兒 子 
皴=法 裂 
枉=死 然 法 顧 駕 自 
濱=海 江 湖 河 城 州 
獷=悍 
刨=花 子 床 冰 刀 工 除 根 坑 土 削 
岬=角 
蹊=徑 蹺 
汾=酒 陽 河 西 
俳=句 優 
嬋=娟 媛 
轍=口 
轔=
囫=圇 
駟=馬 
屆=滿 時 期 
糙=米 糧 
粳=米 稻 
搟=氈 
禾=苗 草 場 
琢=磨 
槁=木 
矚=目 望 
摒=棄 除 絕 
謄=清 寫 印 錄 本 
鹿=茸 角 羔 脯 皮 苑 砦 寨 肉 柴 邑 
髀=
杳=然 渺 
莆=田 
沃=土 爾 田 野 頓 壤 饒 洲 
淅=瀝 
瞞=著 騙 報 哄 過 
傘=形 兵 降 具 包 架 
獠=牙 
讒=言 佞 害 
羚=羊 牛 
熒=幕 屏 光 惑 
蠅=拍 頭 子 虎 
寰=宇 球 
夙=愿 仇 諾 嫌 夜 
皓=月 齒 首 天 龍 
逾=越 期 
耿=直 介 
幣=制 值 市 種 
榧=子 
砧=板 杵 骨 木 子 
腎=病 臟 虛 炎 囊 虧 盂 部 
淄=博 
瘠=薄 瘦 土 
搌=布 
薺=菜 
沱=茶 江 
芽=茶 兒 孢 豆 接 體 眼 
畝=產 
鵬=程 城 飛 
寅=時 
臼=齒 
蠹=蟲 弊 魚 
噠=? 
胞=弟 妹 衣 兄 胎 芽 
掂=量 對 掇 算 
唁=電 函 
喋=血 
怙=恃 
夯=歌 實 土 
鰥=夫 寡 居 
倀=鬼 
狙=擊 
鎧=甲 
勵=志 
趑=趄 
霉=菌 變 爛 氣 天 頭 雨 素 味 
鏗=鏘 然 
祁=連 門 縣 陽 
銖=
蓖=麻 
砝=碼 
魑=魅 
靡=然 麗 費 
粟=米 子 
薏=米 苡 
彰=顯 化 武 
孰=料 
忸=怩 
?=啪 
賴=皮 以 斯 婚 學 賬 子 債 床 特 
贗=品 鼎 本 幣 
帥=氣 哥 才 旗 印 
藹=然 
嚅=囁 動 
辰=砂 光 時 星 溪 
潸=然 
帛=書 畫 
樺=樹 林 
硼=酸 砂 
坍=塌 圮 縮 臺 陷 方 
洽=談 購 商 詢 
詠=春 梅 唱 懷 嘆 史 雪 志 贊 
榔=頭 榆 
癮=頭 
獐=子 
穎=悟 慧 果 異 
郫=縣 
昧=心 死 
捫=心 
槽=牙 子 口 鋼 床 車 坊 糕 頭 粕 
齜=
緒=言 論 
汁=液 水 
吠=叫 聲 陀 
粵=語 劇 港 曲 菜 北 東 繡 海 西 
燎=原 泡 
戇=直 頭 
罄=盡 
郡=主 守 王 縣 
雹=子 災 暴 
跛=子 腳 行 
柑=子 橘 果 汁 
貉=子 絨 
